,census_geo_id,year,avg_household_earnings,avg_household_earnings_with_earnings,avg_household_earnings_no_earnings
2,310M200US10180,2015,59372,46642,12730
4,310M200US10380,2015,109586,51657,57929
5,310M200US10420,2015,282456,214177,68279
7,310M200US10500,2015,57597,41340,16257
8,310M200US10540,2015,46315,32960,13355
9,310M200US10580,2015,342766,267936,74830
11,310M200US10740,2015,342590,256127,86463
12,310M200US10780,2015,54406,39794,14612
13,310M200US10900,2015,314985,244400,70585
14,310M200US11020,2015,52830,35182,17648
15,310M200US11100,2015,95626,77915,17711
16,310M200US11180,2015,37264,30733,6531
17,310M200US11260,2015,135601,117764,17837
18,310M200US11460,2015,138099,112547,25552
19,310M200US11500,2015,44323,31773,12550
20,310M200US11540,2015,90489,73825,16664
21,310M200US11640,2015,66729,31439,35290
22,310M200US11700,2015,184983,132107,52876
26,310M200US12020,2015,76704,59363,17341
27,310M200US12060,2015,2028705,1689862,338843
28,310M200US12100,2015,101813,78018,23795
30,310M200US12220,2015,58191,45919,12272
31,310M200US12260,2015,210854,157390,53464
33,310M200US12420,2015,723914,622903,101011
34,310M200US12540,2015,263273,207097,56176
35,310M200US12580,2015,1037443,824125,213318
36,310M200US12620,2015,59099,42262,16837
37,310M200US12700,2015,97451,69186,28265
38,310M200US12940,2015,300535,235764,64771
39,310M200US12980,2015,53076,37333,15743
40,310M200US13020,2015,42799,28457,14342
41,310M200US13140,2015,153283,115426,37857
43,310M200US13220,2015,49070,30469,18601
44,310M200US13380,2015,80023,60497,19526
45,310M200US13460,2015,69424,50574,18850
46,310M200US13740,2015,68021,54537,13484
47,310M200US13780,2015,97883,70345,27538
48,310M200US13820,2015,441762,331710,110052
49,310M200US13900,2015,55092,46058,9034
50,310M200US13980,2015,69396,53805,15591
51,310M200US14010,2015,72767,59456,13311
52,310M200US14020,2015,62702,50048,12654
53,310M200US14100,2015,33140,23629,9511
55,310M200US14260,2015,245109,189792,55317
56,310M200US14460,2015,1782655,1441404,341251
57,310M200US14500,2015,124615,103826,20789
58,310M200US14540,2015,62500,46568,15932
62,310M200US14740,2015,98490,75234,23256
63,310M200US14860,2015,333528,270310,63218
64,310M200US15180,2015,122468,94223,28245
65,310M200US15260,2015,46647,34602,12045
66,310M200US15380,2015,467992,340078,127914
67,310M200US15500,2015,63093,46957,16136
68,310M200US15540,2015,85553,69592,15961
69,310M200US15680,2015,39029,32295,6734
70,310M200US15940,2015,162868,123270,39598
71,310M200US15980,2015,263694,165153,98541
72,310M200US16020,2015,35273,26295,8978
73,310M200US16060,2015,48012,34875,13137
74,310M200US16180,2015,22687,16116,6571
75,310M200US16220,2015,32564,26287,6277
76,310M200US16300,2015,107586,86370,21216
78,310M200US16540,2015,59486,45837,13649
79,310M200US16580,2015,92268,72658,19610
80,310M200US16620,2015,94533,65028,29505
82,310M200US16700,2015,273722,216124,57598
83,310M200US16740,2015,905696,732182,173514
84,310M200US16820,2015,87949,70800,17149
85,310M200US16860,2015,209340,155817,53523
86,310M200US16940,2015,37740,29861,7879
87,310M200US16980,2015,3470993,2789467,681526
88,310M200US17020,2015,85289,60960,24329
90,310M200US17140,2015,832607,655730,176877
93,310M200US17300,2015,101265,84320,16945
95,310M200US17420,2015,46389,33513,12876
96,310M200US17460,2015,849475,633798,215677
97,310M200US17660,2015,58675,43023,15652
98,310M200US17780,2015,90526,76081,14445
99,310M200US17820,2015,261435,213895,47540
100,310M200US17860,2015,69152,57386,11766
101,310M200US17900,2015,302634,236319,66315
102,310M200US17980,2015,112983,83754,29229
103,310M200US18020,2015,31131,24613,6518
104,310M200US18140,2015,772304,627730,144574
109,310M200US18580,2015,161634,127927,33707
110,310M200US18700,2015,35062,25990,9072
111,310M200US18880,2015,102729,78319,24410
113,310M200US19060,2015,39120,25233,13887
114,310M200US19100,2015,2479995,2114804,365191
115,310M200US19140,2015,48631,37981,10650
116,310M200US19180,2015,30927,21695,9232
118,310M200US19300,2015,72269,51114,21155
119,310M200US19340,2015,155753,117526,38227
120,310M200US19380,2015,330430,247943,82487
121,310M200US19460,2015,60697,43685,17012
122,310M200US19500,2015,44429,31396,13033
123,310M200US19660,2015,248938,159355,89583
124,310M200US19740,2015,1075919,903913,172006
125,310M200US19780,2015,242022,203303,38719
126,310M200US19820,2015,1674251,1251330,422921
127,310M200US20020,2015,55973,39932,16041
128,310M200US20100,2015,62477,46541,15936
130,310M200US20220,2015,37784,30109,7675
131,310M200US20260,2015,116212,84930,31282
133,310M200US20500,2015,215294,174853,40441
134,310M200US20700,2015,55681,42755,12926
135,310M200US20740,2015,63854,49582,14272
136,310M200US20940,2015,45158,33682,11476
138,310M200US21060,2015,56899,43737,13162
139,310M200US21140,2015,68498,54045,14453
140,310M200US21300,2015,34546,24708,9838
141,310M200US21340,2015,261529,211363,50166
142,310M200US21500,2015,110138,80380,29758
143,310M200US21660,2015,146602,106452,40150
145,310M200US21780,2015,124936,94780,30156
146,310M200US21820,2015,35475,31267,4208
147,310M200US22020,2015,96142,80173,15969
150,310M200US22140,2015,43030,34638,8392
151,310M200US22180,2015,137158,104938,32220
152,310M200US22220,2015,190860,152291,38569
154,310M200US22380,2015,45911,37225,8686
155,310M200US22420,2015,163488,112734,50754
156,310M200US22500,2015,79914,58017,21897
157,310M200US22520,2015,60663,41293,19370
158,310M200US22540,2015,40295,31780,8515
160,310M200US22660,2015,129210,103374,25836
161,310M200US22900,2015,107375,76285,31090
162,310M200US23060,2015,165857,130655,35202
164,310M200US23420,2015,304209,242741,61468
165,310M200US23460,2015,39332,27903,11429
166,310M200US23540,2015,102219,79372,22847
167,310M200US23580,2015,63989,51691,12298
169,310M200US23900,2015,38459,29720,8739
170,310M200US24020,2015,48814,36073,12741
172,310M200US24140,2015,47490,35626,11864
173,310M200US24220,2015,42166,34565,7601
174,310M200US24260,2015,31703,26084,5619
175,310M200US24300,2015,59066,46070,12996
176,310M200US24340,2015,383194,307299,75895
177,310M200US24420,2015,35918,21994,13924
178,310M200US24500,2015,34375,24579,9796
179,310M200US24540,2015,97822,82181,15641
180,310M200US24580,2015,127779,101016,26763
183,310M200US24660,2015,291088,220759,70329
184,310M200US24780,2015,68374,54517,13857
185,310M200US24860,2015,332740,250932,81808
187,310M200US25020,2015,26854,11760,15094
188,310M200US25060,2015,146228,106262,39966
189,310M200US25180,2015,97209,75843,21366
190,310M200US25220,2015,46263,35924,10339
191,310M200US25260,2015,42692,34676,8016
192,310M200US25420,2015,225810,176472,49338
193,310M200US25500,2015,47600,38511,9089
194,310M200US25540,2015,464613,366959,97654
195,310M200US25620,2015,54780,41173,13607
198,310M200US25860,2015,140097,97044,43053
200,310M200US25940,2015,78824,52455,26369
201,310M200US25980,2015,27874,22154,5720
204,310M200US26140,2015,60541,31266,29275
205,310M200US26300,2015,40134,27998,12136
206,310M200US26380,2015,77548,58572,18976
207,310M200US26420,2015,2292992,1976129,316863
208,310M200US26580,2015,140735,93459,47276
209,310M200US26620,2015,172549,134622,37927
212,310M200US26820,2015,45611,35930,9681
214,310M200US26900,2015,755100,605141,149959
215,310M200US26980,2015,64183,54287,9896
216,310M200US27060,2015,38112,29821,8291
217,310M200US27100,2015,59292,42965,16327
218,310M200US27140,2015,210443,163679,46764
219,310M200US27180,2015,49318,36736,12582
220,310M200US27260,2015,536299,415550,120749
221,310M200US27340,2015,64771,55387,9384
223,310M200US27500,2015,65054,50417,14637
224,310M200US27620,2015,55448,42356,13092
225,310M200US27740,2015,83074,57660,25414
226,310M200US27780,2015,57044,38568,18476
227,310M200US27860,2015,48943,36568,12375
228,310M200US27900,2015,67439,52260,15179
229,310M200US27980,2015,52170,41892,10278
230,310M200US28020,2015,129792,101487,28305
232,310M200US28100,2015,38755,28285,10470
233,310M200US28140,2015,814092,651339,162753
236,310M200US28420,2015,94423,76285,18138
238,310M200US28660,2015,151623,120765,30858
239,310M200US28700,2015,126840,84575,42265
240,310M200US28740,2015,69594,53172,16422
242,310M200US28940,2015,343331,250233,93098
243,310M200US29020,2015,34714,23963,10751
244,310M200US29100,2015,54008,42610,11398
245,310M200US29180,2015,180902,140032,40870
246,310M200US29200,2015,81069,65851,15218
248,310M200US29340,2015,79853,61274,18579
250,310M200US29420,2015,83801,48837,34964
251,310M200US29460,2015,227122,157479,69643
252,310M200US29540,2015,197706,157454,40252
253,310M200US29620,2015,183888,142009,41879
254,310M200US29700,2015,72259,60196,12063
255,310M200US29740,2015,74631,56467,18164
256,310M200US29820,2015,740966,582947,158019
258,310M200US29940,2015,42817,34395,8422
259,310M200US30020,2015,43678,34697,8981
260,310M200US30140,2015,53200,40725,12475
261,310M200US30300,2015,25354,17785,7569
262,310M200US30340,2015,45138,34309,10829
263,310M200US30460,2015,199299,163438,35861
264,310M200US30620,2015,40234,30348,9886
265,310M200US30700,2015,127316,106418,20898
266,310M200US30780,2015,282914,216668,66246
267,310M200US30860,2015,40927,34815,6112
269,310M200US30980,2015,76401,60378,16023
270,310M200US31020,2015,40187,28027,12160
271,310M200US31080,2015,4315637,3555491,760146
272,310M200US31140,2015,496455,385369,111086
273,310M200US31180,2015,112853,92015,20838
276,310M200US31340,2015,100497,76060,24437
277,310M200US31420,2015,86400,60976,25424
278,310M200US31460,2015,45224,33793,11431
279,310M200US31540,2015,264340,221844,42496
280,310M200US31700,2015,156678,128449,28229
281,310M200US31740,2015,34806,29702,5104
283,310M200US31860,2015,38444,32043,6401
284,310M200US31900,2015,46989,34572,12417
291,310M200US32420,2015,36870,17267,19603
292,310M200US32580,2015,225692,182165,43527
294,310M200US32780,2015,83876,58334,25542
295,310M200US32820,2015,494270,389986,104284
296,310M200US32900,2015,79098,60723,18375
298,310M200US33100,2015,2077362,1597001,480361
299,310M200US33140,2015,43169,31818,11351
300,310M200US33220,2015,32977,24531,8446
301,310M200US33260,2015,57867,50542,7325
302,310M200US33340,2015,627842,488333,139509
303,310M200US33460,2015,1354766,1123115,231651
305,310M200US33540,2015,47910,37417,10493
306,310M200US33660,2015,152938,111418,41520
307,310M200US33700,2015,171960,133367,38593
308,310M200US33740,2015,64955,46891,18064
309,310M200US33780,2015,58886,43489,15397
310,310M200US33860,2015,144379,107652,36727
312,310M200US34060,2015,50274,36082,14192
313,310M200US34100,2015,44574,31055,13519
317,310M200US34580,2015,48056,35959,12097
318,310M200US34620,2015,45278,33413,11865
319,310M200US34740,2015,63215,45743,17472
321,310M200US34820,2015,174808,118106,56702
323,310M200US34900,2015,49619,38436,11183
324,310M200US34940,2015,134906,86301,48605
325,310M200US34980,2015,686640,564463,122177
326,310M200US35100,2015,51013,36927,14086
328,310M200US35300,2015,323270,245975,77295
329,310M200US35380,2015,481754,374560,107194
331,310M200US35620,2015,7125065,5660311,1464754
332,310M200US35660,2015,64279,48205,16074
333,310M200US35840,2015,312497,192414,120083
335,310M200US35980,2015,105376,81665,23711
337,310M200US36100,2015,125227,67489,57738
338,310M200US36140,2015,38708,26770,11938
339,310M200US36220,2015,52023,45317,6706
340,310M200US36260,2015,201165,166877,34288
342,310M200US36420,2015,505074,402664,102410
344,310M200US36500,2015,105159,78491,26668
345,310M200US36540,2015,351446,291878,59568
348,310M200US36740,2015,845295,678003,167292
349,310M200US36780,2015,69636,54041,15595
351,310M200US36980,2015,46415,34910,11505
353,310M200US37100,2015,269566,221551,48015
356,310M200US37340,2015,225682,150625,75057
357,310M200US37460,2015,74276,55545,18731
358,310M200US37620,2015,39349,26681,12668
359,310M200US37860,2015,177675,133868,43807
360,310M200US37900,2015,150639,114707,35932
361,310M200US37980,2015,2233752,1750852,482900
362,310M200US38060,2015,1608722,1240688,368034
363,310M200US38220,2015,34059,23056,11003
365,310M200US38300,2015,990355,734522,255833
366,310M200US38340,2015,55497,40160,15337
368,310M200US38540,2015,30174,22839,7335
369,310M200US38660,2015,104647,54628,50019
371,310M200US38860,2015,212240,166327,45913
372,310M200US38900,2015,901402,722390,179012
373,310M200US38940,2015,173912,109936,63976
376,310M200US39140,2015,94920,60822,34098
377,310M200US39300,2015,622607,472502,150105
378,310M200US39340,2015,158270,139879,18391
379,310M200US39380,2015,61876,42241,19635
380,310M200US39460,2015,72671,38052,34619
382,310M200US39540,2015,74960,58467,16493
383,310M200US39580,2015,470527,398392,72135
384,310M200US39660,2015,58598,46290,12308
385,310M200US39740,2015,151792,115530,36262
386,310M200US39820,2015,69799,46389,23410
387,310M200US39900,2015,174571,135580,38991
389,310M200US40060,2015,483127,384332,98795
391,310M200US40140,2015,1343526,1059021,284505
392,310M200US40220,2015,127273,96324,30949
394,310M200US40340,2015,83418,66948,16470
395,310M200US40380,2015,427520,318500,109020
396,310M200US40420,2015,132190,99907,32283
397,310M200US40580,2015,57450,39690,17760
398,310M200US40660,2015,34931,24457,10474
402,310M200US40900,2015,809295,620109,189186
403,310M200US40980,2015,77211,52101,25110
404,310M200US41060,2015,74617,61680,12937
405,310M200US41100,2015,52453,37158,15295
406,310M200US41140,2015,46518,36670,9848
407,310M200US41180,2015,1108303,859828,248475
409,310M200US41420,2015,144600,108694,35906
410,310M200US41500,2015,126904,102919,23985
411,310M200US41540,2015,154242,111926,42316
412,310M200US41620,2015,377058,322418,54640
413,310M200US41660,2015,45137,35440,9697
414,310M200US41700,2015,791273,635527,155746
415,310M200US41740,2015,1113610,906450,207160
417,310M200US41860,2015,1689907,1384702,305205
418,310M200US41900,2015,43954,19213,24741
419,310M200US41940,2015,651352,550082,101270
420,310M200US41980,2015,782561,447908,334653
421,310M200US42020,2015,104760,79301,25459
422,310M200US42100,2015,93317,74695,18622
423,310M200US42140,2015,60642,45334,15308
424,310M200US42200,2015,144261,116990,27271
425,310M200US42220,2015,190662,149278,41384
426,310M200US42340,2015,138784,110341,28443
427,310M200US42540,2015,221200,160042,61158
429,310M200US42660,2015,1437222,1185172,252050
430,310M200US42680,2015,55494,32070,23424
431,310M200US42700,2015,41116,20958,20158
435,310M200US43100,2015,47438,37450,9988
437,310M200US43300,2015,47538,35951,11587
439,310M200US43340,2015,171531,126898,44633
440,310M200US43420,2015,50202,32995,17207
441,310M200US43580,2015,63198,48884,14314
442,310M200US43620,2015,98273,80126,18147
444,310M200US43780,2015,119494,90343,29151
445,310M200US43900,2015,124570,92719,31851
446,310M200US44060,2015,215652,157676,57976
447,310M200US44100,2015,88081,66839,21242
448,310M200US44140,2015,233619,174210,59409
449,310M200US44180,2015,179752,134361,45391
450,310M200US44220,2015,54232,39036,15196
451,310M200US44300,2015,56116,44988,11128
453,310M200US44420,2015,46768,34682,12086
456,310M200US44700,2015,223062,174774,48288
457,310M200US44940,2015,41017,30005,11012
459,310M200US45060,2015,254001,190654,63347
461,310M200US45220,2015,142295,111664,30631
462,310M200US45300,2015,1166704,841977,324727
463,310M200US45460,2015,66685,48766,17919
464,310M200US45500,2015,54440,38461,15979
465,310M200US45540,2015,51170,17216,33954
466,310M200US45780,2015,242641,183232,59409
467,310M200US45820,2015,93078,69795,23283
470,310M200US45940,2015,127965,102739,25226
472,310M200US46060,2015,395992,286339,109653
474,310M200US46140,2015,380841,298980,81861
476,310M200US46220,2015,84889,62008,22881
478,310M200US46340,2015,78380,61545,16835
480,310M200US46520,2015,307703,255801,51902
481,310M200US46540,2015,114580,81453,33127
482,310M200US46660,2015,48600,35957,12643
483,310M200US46700,2015,145502,115758,29744
484,310M200US47020,2015,35842,27906,7936
485,310M200US47220,2015,50380,38426,11954
486,310M200US47260,2015,642911,514212,128699
487,310M200US47300,2015,134801,107252,27549
488,310M200US47380,2015,93239,70733,22506
489,310M200US47460,2015,24201,16558,7643
490,310M200US47580,2015,69562,54953,14609
492,310M200US47900,2015,2172310,1867549,304761
493,310M200US47940,2015,66986,51336,15650
495,310M200US48060,2015,43145,34051,9094
496,310M200US48140,2015,54558,44285,10273
497,310M200US48260,2015,50699,35248,15451
498,310M200US48300,2015,41304,31187,10117
499,310M200US48540,2015,58313,40280,18033
501,310M200US48620,2015,244522,191806,52716
502,310M200US48660,2015,55562,41742,13820
503,310M200US48700,2015,45751,35011,10740
504,310M200US48900,2015,111546,84454,27092
506,310M200US49020,2015,48995,37575,11420
507,310M200US49180,2015,260437,194164,66273
510,310M200US49340,2015,345269,270534,74735
511,310M200US49420,2015,81709,64237,17472
512,310M200US49620,2015,165672,131458,34214
513,310M200US49660,2015,228692,160866,67826
514,310M200US49700,2015,58262,44095,14167
515,310M200US49740,2015,71751,50091,21660
518,310M300US10180,2016,59263,45169,14094
520,310M300US10380,2016,110316,54767,55549
521,310M300US10420,2016,284670,213625,71045
523,310M300US10500,2016,57228,44473,12755
524,310M300US10540,2016,46645,34016,12629
525,310M300US10580,2016,343069,267553,75516
527,310M300US10740,2016,343912,258645,85267
528,310M300US10780,2016,55246,40186,15060
529,310M300US10900,2016,317457,247637,69820
530,310M300US11020,2016,51154,35769,15385
531,310M300US11100,2016,95619,78320,17299
532,310M300US11180,2016,37350,32585,4765
533,310M300US11260,2016,135554,117851,17703
534,310M300US11460,2016,140079,114894,25185
535,310M300US11500,2016,43972,30496,13476
536,310M300US11540,2016,92593,75534,17059
537,310M300US11640,2016,66520,33527,32993
538,310M300US11700,2016,186656,133317,53339
542,310M300US12020,2016,78195,61117,17078
543,310M300US12060,2016,2062798,1722477,340321
544,310M300US12100,2016,96777,73544,23233
546,310M300US12220,2016,59354,46796,12558
547,310M300US12260,2016,219167,164831,54336
549,310M300US12420,2016,741176,639342,101834
550,310M300US12540,2016,270359,211715,58644
551,310M300US12580,2016,1045165,840152,205013
552,310M300US12620,2016,60195,45253,14942
553,310M300US12700,2016,92582,64230,28352
554,310M300US12940,2016,296740,232399,64341
555,310M300US12980,2016,52888,38229,14659
556,310M300US13020,2016,43876,31404,12472
557,310M300US13140,2016,152244,114121,38123
559,310M300US13220,2016,47940,31628,16312
560,310M300US13380,2016,84011,61958,22053
561,310M300US13460,2016,71262,54703,16559
562,310M300US13740,2016,69484,54204,15280
563,310M300US13780,2016,96261,67039,29222
564,310M300US13820,2016,438479,330436,108043
565,310M300US13900,2016,54085,44900,9185
566,310M300US13980,2016,70441,53359,17082
567,310M300US14010,2016,71716,58945,12771
568,310M300US14020,2016,64040,51431,12609
569,310M300US14100,2016,33824,25269,8555
571,310M300US14260,2016,251142,197518,53624
572,310M300US14460,2016,1803269,1461144,342125
573,310M300US14500,2016,123820,103007,20813
574,310M300US14540,2016,65832,50997,14835
578,310M300US14740,2016,101995,75952,26043
579,310M300US14860,2016,335318,277562,57756
580,310M300US15180,2016,120499,89260,31239
581,310M300US15260,2016,42849,29471,13378
582,310M300US15380,2016,467259,339531,127728
583,310M300US15500,2016,64369,50333,14036
584,310M300US15540,2016,85740,69277,16463
585,310M300US15680,2016,41368,33704,7664
586,310M300US15940,2016,163203,121817,41386
587,310M300US15980,2016,261735,164829,96906
588,310M300US16020,2016,36202,27044,9158
589,310M300US16060,2016,51761,36618,15143
590,310M300US16180,2016,21704,15203,6501
591,310M300US16220,2016,32059,25891,6168
592,310M300US16300,2016,107867,87213,20654
594,310M300US16540,2016,60492,44804,15688
595,310M300US16580,2016,94941,74795,20146
596,310M300US16620,2016,91529,61474,30055
598,310M300US16700,2016,287362,225877,61485
599,310M300US16740,2016,917897,745487,172410
600,310M300US16820,2016,87091,68147,18944
601,310M300US16860,2016,210802,153065,57737
602,310M300US16940,2016,38181,30214,7967
603,310M300US16980,2016,3491635,2807776,683859
604,310M300US17020,2016,85531,58886,26645
606,310M300US17140,2016,841382,666685,174697
609,310M300US17300,2016,100564,79533,21031
611,310M300US17420,2016,47253,36140,11113
612,310M300US17460,2016,851882,639323,212559
613,310M300US17660,2016,58875,43900,14975
614,310M300US17780,2016,91033,77377,13656
615,310M300US17820,2016,267621,222907,44714
616,310M300US17860,2016,68848,56924,11924
617,310M300US17900,2016,309016,243441,65575
618,310M300US17980,2016,113256,83599,29657
619,310M300US18020,2016,31626,25115,6511
620,310M300US18140,2016,779547,633217,146330
625,310M300US18580,2016,161353,127989,33364
626,310M300US18700,2016,34543,26660,7883
627,310M300US18880,2016,103309,78793,24516
629,310M300US19060,2016,38956,27412,11544
630,310M300US19100,2016,2538547,2173172,365375
631,310M300US19140,2016,49692,38005,11687
632,310M300US19180,2016,31928,21218,10710
634,310M300US19300,2016,76779,53865,22914
635,310M300US19340,2016,153275,113995,39280
636,310M300US19380,2016,328352,243735,84617
637,310M300US19460,2016,57753,39325,18428
638,310M300US19500,2016,44002,31454,12548
639,310M300US19660,2016,255350,161859,93491
640,310M300US19740,2016,1091571,921616,169955
641,310M300US19780,2016,245643,205472,40171
642,310M300US19820,2016,1689859,1268517,421342
643,310M300US20020,2016,56133,39227,16906
644,310M300US20100,2016,64452,49011,15441
646,310M300US20220,2016,37710,30404,7306
647,310M300US20260,2016,116967,83814,33153
649,310M300US20500,2016,217853,173816,44037
650,310M300US20700,2016,57284,42576,14708
651,310M300US20740,2016,66866,51758,15108
652,310M300US20940,2016,44855,32777,12078
654,310M300US21060,2016,56261,43249,13012
655,310M300US21140,2016,72487,59441,13046
656,310M300US21300,2016,34418,25258,9160
657,310M300US21340,2016,268172,215884,52288
658,310M300US21420,2016,24859,19956,4903
659,310M300US21500,2016,109705,80494,29211
660,310M300US21660,2016,147712,108544,39168
662,310M300US21780,2016,128277,100971,27306
663,310M300US21820,2016,33770,30969,2801
664,310M300US22020,2016,99968,85299,14669
667,310M300US22140,2016,43093,32951,10142
668,310M300US22180,2016,141972,110461,31511
669,310M300US22220,2016,196775,157917,38858
671,310M300US22380,2016,47408,37986,9422
672,310M300US22420,2016,167171,112170,55001
673,310M300US22500,2016,76117,54624,21493
674,310M300US22520,2016,59676,40774,18902
675,310M300US22540,2016,40815,31593,9222
677,310M300US22660,2016,131407,105223,26184
679,310M300US22900,2016,107196,76573,30623
680,310M300US23060,2016,167408,131669,35739
682,310M300US23420,2016,303216,236277,66939
683,310M300US23460,2016,38766,25727,13039
684,310M300US23540,2016,100985,75083,25902
685,310M300US23580,2016,62038,49208,12830
687,310M300US23900,2016,38125,28068,10057
688,310M300US24020,2016,51614,37531,14083
690,310M300US24140,2016,47240,32463,14777
691,310M300US24220,2016,41827,32583,9244
692,310M300US24260,2016,32945,26880,6065
693,310M300US24300,2016,60188,46116,14072
694,310M300US24340,2016,384790,308891,75899
695,310M300US24420,2016,35439,22411,13028
696,310M300US24500,2016,33759,24615,9144
697,310M300US24540,2016,102087,86112,15975
698,310M300US24580,2016,128474,102573,25901
701,310M300US24660,2016,296476,224540,71936
702,310M300US24780,2016,70019,55293,14726
703,310M300US24860,2016,335497,255147,80350
705,310M300US25020,2016,26740,14349,12391
706,310M300US25060,2016,146020,108564,37456
707,310M300US25180,2016,98193,73314,24879
708,310M300US25220,2016,47756,37053,10703
709,310M300US25260,2016,43090,35679,7411
710,310M300US25420,2016,225120,172765,52355
711,310M300US25500,2016,47805,38374,9431
712,310M300US25540,2016,470439,367975,102464
713,310M300US25620,2016,53560,42510,11050
716,310M300US25860,2016,144399,105559,38840
718,310M300US25940,2016,76772,52013,24759
719,310M300US25980,2016,29918,24276,5642
722,310M300US26140,2016,63581,30937,32644
723,310M300US26300,2016,39309,26925,12384
724,310M300US26380,2016,77301,59515,17786
725,310M300US26420,2016,2333038,1995803,337235
726,310M300US26580,2016,141737,94451,47286
727,310M300US26620,2016,175549,136488,39061
730,310M300US26820,2016,48326,38989,9337
732,310M300US26900,2016,765240,614175,151065
733,310M300US26980,2016,65343,54208,11135
734,310M300US27060,2016,37683,29199,8484
735,310M300US27100,2016,59993,43388,16605
736,310M300US27140,2016,213266,165723,47543
737,310M300US27180,2016,48047,33039,15008
738,310M300US27260,2016,551172,427963,123209
739,310M300US27340,2016,61766,50480,11286
741,310M300US27500,2016,63222,47699,15523
742,310M300US27620,2016,55366,41714,13652
743,310M300US27740,2016,83349,58775,24574
744,310M300US27780,2016,56443,38465,17978
745,310M300US27860,2016,49513,38583,10930
746,310M300US27900,2016,67380,52398,14982
747,310M300US27980,2016,53667,43137,10530
748,310M300US28020,2016,131673,100809,30864
750,310M300US28100,2016,39314,30258,9056
751,310M300US28140,2016,816569,662069,154500
754,310M300US28420,2016,96337,77209,19128
756,310M300US28660,2016,150422,121575,28847
757,310M300US28700,2016,123757,81679,42078
758,310M300US28740,2016,68298,52161,16137
760,310M300US28940,2016,344803,254624,90179
761,310M300US29020,2016,34195,23274,10921
762,310M300US29100,2016,55390,43083,12307
763,310M300US29180,2016,177425,136404,41021
764,310M300US29200,2016,80560,66830,13730
766,310M300US29340,2016,79226,58404,20822
768,310M300US29420,2016,84876,47590,37286
769,310M300US29460,2016,226429,154715,71714
770,310M300US29540,2016,196807,157036,39771
771,310M300US29620,2016,185389,142990,42399
772,310M300US29700,2016,73483,58722,14761
773,310M300US29740,2016,75759,56729,19030
774,310M300US29820,2016,755258,593561,161697
776,310M300US29940,2016,45572,39311,6261
777,310M300US30020,2016,45111,35538,9573
778,310M300US30140,2016,51143,37806,13337
779,310M300US30300,2016,26373,18073,8300
780,310M300US30340,2016,44917,34582,10335
781,310M300US30460,2016,197789,160591,37198
782,310M300US30620,2016,39982,29536,10446
783,310M300US30700,2016,128292,107832,20460
784,310M300US30780,2016,285036,217680,67356
785,310M300US30860,2016,41158,35496,5662
787,310M300US30980,2016,77356,60121,17235
788,310M300US31020,2016,40170,27057,13113
789,310M300US31080,2016,4337807,3578470,759337
790,310M300US31140,2016,501827,392810,109017
791,310M300US31180,2016,116122,95775,20347
794,310M300US31340,2016,97679,71284,26395
795,310M300US31420,2016,86633,60178,26455
796,310M300US31460,2016,44369,32985,11384
797,310M300US31540,2016,265172,222443,42729
798,310M300US31700,2016,158777,130367,28410
799,310M300US31740,2016,34357,28716,5641
801,310M300US31860,2016,37898,31196,6702
802,310M300US31900,2016,48437,34529,13908
809,310M300US32420,2016,35033,15854,19179
810,310M300US32580,2016,234716,187032,47684
812,310M300US32780,2016,86745,61789,24956
813,310M300US32820,2016,501107,397326,103781
814,310M300US32900,2016,77713,60773,16940
816,310M300US33100,2016,2098686,1620374,478312
817,310M300US33140,2016,42074,32596,9478
818,310M300US33220,2016,34381,25415,8966
819,310M300US33260,2016,57814,50964,6850
820,310M300US33340,2016,626328,485662,140666
821,310M300US33460,2016,1363277,1121127,242150
823,310M300US33540,2016,47725,37910,9815
824,310M300US33660,2016,157141,116091,41050
825,310M300US33700,2016,172881,133412,39469
826,310M300US33740,2016,62201,44804,17397
827,310M300US33780,2016,58789,42870,15919
828,310M300US33860,2016,145847,108415,37432
830,310M300US34060,2016,50521,38615,11906
831,310M300US34100,2016,43944,30506,13438
835,310M300US34580,2016,46423,33701,12722
836,310M300US34620,2016,46720,33645,13075
837,310M300US34740,2016,65437,47637,17800
839,310M300US34820,2016,179893,118822,61071
841,310M300US34900,2016,49561,38165,11396
842,310M300US34940,2016,139522,88130,51392
843,310M300US34980,2016,706627,581784,124843
844,310M300US35100,2016,49233,34951,14282
846,310M300US35300,2016,327560,256097,71463
847,310M300US35380,2016,482980,370263,112717
849,310M300US35620,2016,7118024,5655355,1462669
850,310M300US35660,2016,62538,46344,16194
851,310M300US35840,2016,318656,194069,124587
853,310M300US35980,2016,105113,83093,22020
855,310M300US36100,2016,134239,78548,55691
856,310M300US36140,2016,38895,26827,12068
857,310M300US36220,2016,51012,43767,7245
858,310M300US36260,2016,203877,169678,34199
860,310M300US36420,2016,510666,409539,101127
862,310M300US36500,2016,105863,81334,24529
863,310M300US36540,2016,352723,289530,63193
866,310M300US36740,2016,862521,683124,179397
867,310M300US36780,2016,69943,54764,15179
869,310M300US36980,2016,46803,34120,12683
871,310M300US37100,2016,268091,216581,51510
874,310M300US37340,2016,226021,150887,75134
875,310M300US37460,2016,75906,56272,19634
876,310M300US37620,2016,37097,24668,12429
877,310M300US37860,2016,180519,135996,44523
878,310M300US37900,2016,151258,113687,37571
879,310M300US37980,2016,2241237,1743948,497289
880,310M300US38060,2016,1653483,1282185,371298
881,310M300US38220,2016,33901,23057,10844
883,310M300US38300,2016,984297,733063,251234
884,310M300US38340,2016,54204,40116,14088
886,310M300US38540,2016,30106,22893,7213
887,310M300US38660,2016,105240,55318,49922
889,310M300US38860,2016,216799,168335,48464
890,310M300US38900,2016,918590,738901,179689
891,310M300US38940,2016,174593,114262,60331
894,310M300US39140,2016,94962,56431,38531
895,310M300US39300,2016,622471,470101,152370
896,310M300US39340,2016,160979,142410,18569
897,310M300US39380,2016,62275,43140,19135
898,310M300US39460,2016,75147,37942,37205
900,310M300US39540,2016,75921,58538,17383
901,310M300US39580,2016,477920,404141,73779
902,310M300US39660,2016,56614,44441,12173
903,310M300US39740,2016,150402,117644,32758
904,310M300US39820,2016,72095,48156,23939
905,310M300US39900,2016,176627,137007,39620
907,310M300US40060,2016,486877,389614,97263
909,310M300US40140,2016,1348213,1063499,284714
910,310M300US40220,2016,127319,93403,33916
912,310M300US40340,2016,85948,68858,17090
913,310M300US40380,2016,430873,323852,107021
914,310M300US40420,2016,133670,102403,31267
915,310M300US40580,2016,56153,41479,14674
916,310M300US40660,2016,35411,26023,9388
920,310M300US40900,2016,816902,629973,186929
921,310M300US40980,2016,78494,54134,24360
922,310M300US41060,2016,74834,61136,13698
923,310M300US41100,2016,51774,35290,16484
924,310M300US41140,2016,48068,34505,13563
925,310M300US41180,2016,1113234,866033,247201
927,310M300US41420,2016,146078,110720,35358
928,310M300US41500,2016,125740,102909,22831
929,310M300US41540,2016,149074,106137,42937
930,310M300US41620,2016,386481,331542,54939
931,310M300US41660,2016,44044,36037,8007
932,310M300US41700,2016,796140,641323,154817
933,310M300US41740,2016,1110568,903697,206871
935,310M300US41860,2016,1691781,1395552,296229
936,310M300US41900,2016,43167,20609,22558
937,310M300US41940,2016,653296,558064,95232
938,310M300US41980,2016,770603,450726,319877
939,310M300US42020,2016,106312,78740,27572
940,310M300US42100,2016,96257,75337,20920
941,310M300US42140,2016,60096,44292,15804
942,310M300US42200,2016,142449,114343,28106
943,310M300US42220,2016,187504,144774,42730
944,310M300US42340,2016,143081,115744,27337
945,310M300US42540,2016,220572,157925,62647
947,310M300US42660,2016,1464941,1214835,250106
948,310M300US42680,2016,55427,29800,25627
949,310M300US42700,2016,38808,20682,18126
953,310M300US43100,2016,47652,37168,10484
955,310M300US43300,2016,47135,34972,12163
957,310M300US43340,2016,170899,124793,46106
958,310M300US43420,2016,50147,33270,16877
959,310M300US43580,2016,64589,52444,12145
960,310M300US43620,2016,98176,82159,16017
962,310M300US43780,2016,117259,87003,30256
963,310M300US43900,2016,125096,93665,31431
964,310M300US44060,2016,217598,163675,53923
965,310M300US44100,2016,87484,64357,23127
966,310M300US44140,2016,236790,176895,59895
967,310M300US44180,2016,181989,134967,47022
968,310M300US44220,2016,54548,39458,15090
969,310M300US44300,2016,57410,45358,12052
971,310M300US44420,2016,50508,37029,13479
974,310M300US44700,2016,227186,178742,48444
975,310M300US44940,2016,41439,30465,10974
977,310M300US45060,2016,253229,188578,64651
979,310M300US45220,2016,142991,114426,28565
980,310M300US45300,2016,1191645,859413,332232
981,310M300US45460,2016,64837,48895,15942
982,310M300US45500,2016,53799,38860,14939
983,310M300US45540,2016,51781,16379,35402
984,310M300US45780,2016,247069,188759,58310
985,310M300US45820,2016,92086,69349,22737
988,310M300US45940,2016,128332,101338,26994
990,310M300US46060,2016,400835,289528,111307
992,310M300US46140,2016,381722,299827,81895
994,310M300US46220,2016,86680,65135,21545
996,310M300US46340,2016,75792,57143,18649
998,310M300US46520,2016,309169,254176,54993
999,310M300US46540,2016,112029,78934,33095
1000,310M300US46660,2016,52103,37890,14213
1001,310M300US46700,2016,149172,119849,29323
1002,310M300US47020,2016,35180,27990,7190
1003,310M300US47220,2016,50787,37016,13771
1004,310M300US47260,2016,639903,518084,121819
1005,310M300US47300,2016,135648,108944,26704
1006,310M300US47380,2016,92256,74364,17892
1007,310M300US47460,2016,23748,17187,6561
1008,310M300US47580,2016,68333,52251,16082
1010,310M300US47900,2016,2191806,1875470,316336
1011,310M300US47940,2016,66869,50830,16039
1013,310M300US48060,2016,41415,32167,9248
1014,310M300US48140,2016,55147,44072,11075
1015,310M300US48260,2016,48495,32759,15736
1016,310M300US48300,2016,43186,31307,11879
1017,310M300US48540,2016,57441,40868,16573
1019,310M300US48620,2016,244765,193237,51528
1020,310M300US48660,2016,56183,43327,12856
1021,310M300US48700,2016,45525,34297,11228
1022,310M300US48900,2016,114024,84615,29409
1024,310M300US49020,2016,52538,39534,13004
1025,310M300US49180,2016,258760,192918,65842
1028,310M300US49340,2016,349567,275261,74306
1029,310M300US49420,2016,81084,62725,18359
1030,310M300US49620,2016,169885,132707,37178
1031,310M300US49660,2016,228427,160123,68304
1032,310M300US49700,2016,59044,44464,14580
1033,310M300US49740,2016,73072,51724,21348
1036,310M300US10180,2017,61603,47545,14058
1038,310M300US10380,2017,112215,57104,55111
1039,310M300US10420,2017,289282,221658,67624
1041,310M300US10500,2017,57607,41808,15799
1042,310M300US10540,2017,47188,35606,11582
1043,310M300US10580,2017,348421,268645,79776
1045,310M300US10740,2017,347357,257835,89522
1046,310M300US10780,2017,55634,39000,16634
1047,310M300US10900,2017,320990,244677,76313
1048,310M300US11020,2017,51885,35905,15980
1049,310M300US11100,2017,97963,79366,18597
1050,310M300US11180,2017,37689,32640,5049
1051,310M300US11260,2017,136816,117159,19657
1052,310M300US11460,2017,140729,115309,25420
1053,310M300US11500,2017,44507,31882,12625
1054,310M300US11540,2017,94400,75830,18570
1055,310M300US11640,2017,68855,34495,34360
1056,310M300US11700,2017,190004,136169,53835
1060,310M300US12020,2017,76556,61166,15390
1061,310M300US12060,2017,2102145,1756081,346064
1062,310M300US12100,2017,97618,72235,25383
1064,310M300US12220,2017,58555,45429,13126
1065,310M300US12260,2017,211489,154529,56960
1067,310M300US12420,2017,755333,652240,103093
1068,310M300US12540,2017,269147,212223,56924
1069,310M300US12580,2017,1053386,843403,209983
1070,310M300US12620,2017,60620,45360,15260
1071,310M300US12700,2017,92148,63985,28163
1072,310M300US12940,2017,299655,235090,64565
1073,310M300US12980,2017,54556,39136,15420
1074,310M300US13020,2017,44907,29904,15003
1075,310M300US13140,2017,149713,111351,38362
1077,310M300US13220,2017,48342,30199,18143
1078,310M300US13380,2017,88636,68036,20600
1079,310M300US13460,2017,74498,57045,17453
1080,310M300US13740,2017,70979,56177,14802
1081,310M300US13780,2017,99370,69347,30023
1082,310M300US13820,2017,439543,328303,111240
1083,310M300US13900,2017,55632,45528,10104
1084,310M300US13980,2017,66947,50435,16512
1085,310M300US14010,2017,71476,55394,16082
1086,310M300US14020,2017,64763,51571,13192
1087,310M300US14100,2017,33823,25278,8545
1089,310M300US14260,2017,257970,202740,55230
1090,310M300US14460,2017,1823034,1480023,343011
1091,310M300US14500,2017,128497,107355,21142
1092,310M300US14540,2017,65444,50979,14465
1096,310M300US14740,2017,104902,79212,25690
1097,310M300US14860,2017,336433,274540,61893
1098,310M300US15180,2017,123024,93618,29406
1099,310M300US15260,2017,45891,30964,14927
1100,310M300US15380,2017,475055,349560,125495
1101,310M300US15500,2017,64371,49047,15324
1102,310M300US15540,2017,87914,71985,15929
1103,310M300US15680,2017,40820,33924,6896
1104,310M300US15940,2017,165473,123183,42290
1105,310M300US15980,2017,266266,170818,95448
1106,310M300US16020,2017,37032,27368,9664
1107,310M300US16060,2017,50153,36141,14012
1108,310M300US16180,2017,22773,16874,5899
1109,310M300US16220,2017,32556,26651,5905
1110,310M300US16300,2017,107802,88430,19372
1112,310M300US16540,2017,60979,45205,15774
1113,310M300US16580,2017,95429,73849,21580
1114,310M300US16620,2017,87463,58463,29000
1115,310M300US16700,2017,290586,232052,58534
1116,310M300US16740,2017,944261,767409,176852
1117,310M300US16820,2017,88632,69494,19138
1118,310M300US16860,2017,220186,159650,60536
1119,310M300US16940,2017,39054,30209,8845
1120,310M300US16980,2017,3488312,2800656,687656
1121,310M300US17020,2017,88797,61728,27069
1123,310M300US17140,2017,852639,675609,177030
1126,310M300US17300,2017,105056,84783,20273
1128,310M300US17420,2017,47923,36512,11411
1129,310M300US17460,2017,862586,638594,223992
1130,310M300US17660,2017,60383,44555,15828
1131,310M300US17780,2017,91999,74723,17276
1132,310M300US17820,2017,268122,217548,50574
1133,310M300US17860,2017,70355,57414,12941
1134,310M300US17900,2017,309760,242288,67472
1135,310M300US17980,2017,112937,82704,30233
1136,310M300US18020,2017,31498,24369,7129
1137,310M300US18140,2017,788946,642733,146213
1142,310M300US18580,2017,160796,124852,35944
1143,310M300US18700,2017,35445,27852,7593
1144,310M300US18880,2017,108474,83583,24891
1146,310M300US19060,2017,37611,25094,12517
1147,310M300US19100,2017,2573711,2198981,374730
1148,310M300US19140,2017,48645,37311,11334
1149,310M300US19180,2017,30241,20285,9956
1151,310M300US19300,2017,79120,55023,24097
1152,310M300US19340,2017,151284,112777,38507
1153,310M300US19380,2017,329442,245768,83674
1154,310M300US19460,2017,56691,39270,17421
1155,310M300US19500,2017,42977,30885,12092
1156,310M300US19660,2017,260002,165984,94018
1157,310M300US19740,2017,1105758,936594,169164
1158,310M300US19780,2017,250612,209823,40789
1159,310M300US19820,2017,1707501,1286093,421408
1160,310M300US20020,2017,55442,39382,16060
1161,310M300US20100,2017,63807,49236,14571
1163,310M300US20220,2017,37785,29336,8449
1164,310M300US20260,2017,117874,84674,33200
1166,310M300US20500,2017,224437,182418,42019
1167,310M300US20700,2017,57668,44575,13093
1168,310M300US20740,2017,67079,52929,14150
1169,310M300US20940,2017,44478,33931,10547
1171,310M300US21060,2017,57979,45489,12490
1172,310M300US21140,2017,73363,60400,12963
1173,310M300US21300,2017,32247,23078,9169
1174,310M300US21340,2017,270076,219916,50160
1175,310M300US21420,2017,22784,17369,5415
1176,310M300US21500,2017,108458,79332,29126
1177,310M300US21660,2017,151675,111624,40051
1179,310M300US21780,2017,130667,98584,32083
1180,310M300US21820,2017,35046,31608,3438
1181,310M300US22020,2017,100721,87106,13615
1184,310M300US22140,2017,41071,30845,10226
1185,310M300US22180,2017,143306,111977,31329
1186,310M300US22220,2017,194671,158874,35797
1188,310M300US22380,2017,47977,38142,9835
1189,310M300US22420,2017,165719,115902,49817
1190,310M300US22500,2017,79458,58439,21019
1191,310M300US22520,2017,60041,41831,18210
1192,310M300US22540,2017,42449,33507,8942
1194,310M300US22660,2017,134709,106288,28421
1196,310M300US22900,2017,108133,76941,31192
1197,310M300US23060,2017,168359,132868,35491
1199,310M300US23420,2017,305819,243201,62618
1200,310M300US23460,2017,37091,22921,14170
1201,310M300US23540,2017,104101,78345,25756
1202,310M300US23580,2017,62164,50090,12074
1204,310M300US23900,2017,39527,29744,9783
1205,310M300US24020,2017,50135,36752,13383
1207,310M300US24140,2017,47720,35654,12066
1208,310M300US24220,2017,42613,33933,8680
1209,310M300US24260,2017,32578,26897,5681
1210,310M300US24300,2017,61763,45508,16255
1211,310M300US24340,2017,394268,317399,76869
1212,310M300US24420,2017,36493,21961,14532
1213,310M300US24500,2017,33346,25137,8209
1214,310M300US24540,2017,104611,87321,17290
1215,310M300US24580,2017,129383,102655,26728
1218,310M300US24660,2017,297140,228511,68629
1219,310M300US24780,2017,68505,54191,14314
1220,310M300US24860,2017,343167,263462,79705
1222,310M300US25020,2017,25610,10960,14650
1223,310M300US25060,2017,150780,111515,39265
1224,310M300US25180,2017,98959,74512,24447
1225,310M300US25220,2017,49272,36730,12542
1226,310M300US25260,2017,43029,35893,7136
1227,310M300US25420,2017,226354,177616,48738
1228,310M300US25500,2017,47777,37713,10064
1229,310M300US25540,2017,470731,367254,103477
1230,310M300US25620,2017,54181,41253,12928
1233,310M300US25860,2017,141250,102662,38588
1235,310M300US25940,2017,79217,52971,26246
1236,310M300US25980,2017,29826,25237,4589
1239,310M300US26140,2017,61290,31982,29308
1240,310M300US26300,2017,38594,26277,12317
1241,310M300US26380,2017,77302,56750,20552
1242,310M300US26420,2017,2324758,1980832,343926
1243,310M300US26580,2017,139983,89204,50779
1244,310M300US26620,2017,180708,141493,39215
1247,310M300US26820,2017,50941,40861,10080
1249,310M300US26900,2017,773361,619529,153832
1250,310M300US26980,2017,67822,56691,11131
1251,310M300US27060,2017,40230,32675,7555
1252,310M300US27100,2017,62220,45995,16225
1253,310M300US27140,2017,211178,163514,47664
1254,310M300US27180,2017,47865,33892,13973
1255,310M300US27260,2017,560169,435733,124436
1256,310M300US27340,2017,62941,51495,11446
1258,310M300US27500,2017,64878,49028,15850
1260,310M300US27620,2017,54732,42755,11977
1261,310M300US27740,2017,83579,58141,25438
1262,310M300US27780,2017,56023,37746,18277
1263,310M300US27860,2017,51087,40300,10787
1264,310M300US27900,2017,69136,53045,16091
1265,310M300US27980,2017,53616,43139,10477
1266,310M300US28020,2017,133112,103770,29342
1268,310M300US28100,2017,39628,29383,10245
1269,310M300US28140,2017,829475,669999,159476
1272,310M300US28420,2017,98742,77313,21429
1274,310M300US28660,2017,149197,120060,29137
1275,310M300US28700,2017,129285,86665,42620
1276,310M300US28740,2017,68822,53215,15607
1278,310M300US28940,2017,347479,260665,86814
1279,310M300US29020,2017,34243,25185,9058
1280,310M300US29100,2017,55940,44179,11761
1281,310M300US29180,2017,179072,134137,44935
1282,310M300US29200,2017,80855,67069,13786
1284,310M300US29340,2017,81266,62327,18939
1286,310M300US29420,2017,87565,49377,38188
1287,310M300US29460,2017,233058,162991,70067
1288,310M300US29540,2017,201150,160732,40418
1289,310M300US29620,2017,186203,142739,43464
1290,310M300US29700,2017,74045,61904,12141
1291,310M300US29740,2017,75441,52155,23286
1292,310M300US29820,2017,781796,619056,162740
1294,310M300US29940,2017,47643,39598,8045
1295,310M300US30020,2017,46009,36404,9605
1296,310M300US30140,2017,52786,39634,13152
1297,310M300US30300,2017,25553,18088,7465
1298,310M300US30340,2017,45979,34106,11873
1299,310M300US30460,2017,202610,164484,38126
1300,310M300US30620,2017,40872,31148,9724
1301,310M300US30700,2017,129363,108061,21302
1302,310M300US30780,2017,283142,219900,63242
1303,310M300US30860,2017,42764,36640,6124
1305,310M300US30980,2017,76055,59391,16664
1306,310M300US31020,2017,41611,28931,12680
1307,310M300US31080,2017,4348543,3594166,754377
1308,310M300US31140,2017,502581,389753,112828
1309,310M300US31180,2017,116077,94052,22025
1312,310M300US31340,2017,98409,71669,26740
1313,310M300US31420,2017,84028,59251,24777
1314,310M300US31460,2017,46282,36330,9952
1315,310M300US31540,2017,272698,226613,46085
1316,310M300US31700,2017,161414,135358,26056
1317,310M300US31740,2017,35489,30350,5139
1319,310M300US31860,2017,38901,31905,6996
1320,310M300US31900,2017,48998,36239,12759
1327,310M300US32420,2017,35806,16415,19391
1328,310M300US32580,2017,239825,191270,48555
1330,310M300US32780,2017,89701,62295,27406
1331,310M300US32820,2017,493068,384920,108148
1332,310M300US32900,2017,80969,63061,17908
1334,310M300US33100,2017,2105878,1626030,479848
1335,310M300US33140,2017,42385,30305,12080
1336,310M300US33220,2017,34096,25150,8946
1337,310M300US33260,2017,58490,50870,7620
1338,310M300US33340,2017,625495,484545,140950
1339,310M300US33460,2017,1376557,1141182,235375
1341,310M300US33540,2017,48806,39191,9615
1342,310M300US33660,2017,154683,110335,44348
1343,310M300US33700,2017,173573,137891,35682
1344,310M300US33740,2017,66881,48947,17934
1345,310M300US33780,2017,59528,43861,15667
1346,310M300US33860,2017,141960,105570,36390
1348,310M300US34060,2017,51043,39723,11320
1349,310M300US34100,2017,43879,31051,12828
1353,310M300US34580,2017,49262,35283,13979
1354,310M300US34620,2017,46588,34913,11675
1355,310M300US34740,2017,64581,46331,18250
1357,310M300US34820,2017,184898,121645,63253
1359,310M300US34900,2017,47848,36733,11115
1360,310M300US34940,2017,144354,90425,53929
1361,310M300US34980,2017,717370,599025,118345
1362,310M300US35100,2017,49667,34417,15250
1364,310M300US35300,2017,324837,249477,75360
1365,310M300US35380,2017,481828,365640,116188
1367,310M300US35620,2017,7204800,5718242,1486558
1368,310M300US35660,2017,64166,47895,16271
1369,310M300US35840,2017,328943,199909,129034
1371,310M300US35980,2017,107229,85108,22121
1373,310M300US36100,2017,140620,81503,59117
1374,310M300US36140,2017,39526,27951,11575
1375,310M300US36220,2017,51388,44132,7256
1376,310M300US36260,2017,209577,176022,33555
1378,310M300US36420,2017,511242,411171,100071
1380,310M300US36500,2017,112075,88026,24049
1381,310M300US36540,2017,359372,296848,62524
1384,310M300US36740,2017,875259,698742,176517
1385,310M300US36780,2017,70008,54552,15456
1387,310M300US36980,2017,48691,35700,12991
1389,310M300US37100,2017,272085,220230,51855
1392,310M300US37340,2017,228385,152161,76224
1393,310M300US37460,2017,76386,56034,20352
1394,310M300US37620,2017,36629,23922,12707
1395,310M300US37860,2017,184622,139830,44792
1396,310M300US37900,2017,147367,107719,39648
1397,310M300US37980,2017,2282935,1743365,539570
1398,310M300US38060,2017,1675676,1306575,369101
1399,310M300US38220,2017,32431,21480,10951
1401,310M300US38300,2017,996798,737963,258835
1402,310M300US38340,2017,54193,39703,14490
1404,310M300US38540,2017,31384,24365,7019
1405,310M300US38660,2017,103385,50589,52796
1407,310M300US38860,2017,216114,169327,46787
1408,310M300US38900,2017,935722,751966,183756
1409,310M300US38940,2017,176539,115734,60805
1412,310M300US39140,2017,98369,59648,38721
1413,310M300US39300,2017,627318,478427,148891
1414,310M300US39340,2017,167853,149191,18662
1415,310M300US39380,2017,65098,46037,19061
1416,310M300US39460,2017,76056,39830,36226
1418,310M300US39540,2017,77473,60265,17208
1419,310M300US39580,2017,493879,419926,73953
1420,310M300US39660,2017,58171,43703,14468
1421,310M300US39740,2017,155154,120660,34494
1422,310M300US39820,2017,71968,49931,22037
1423,310M300US39900,2017,182846,144497,38349
1425,310M300US40060,2017,481559,388530,93029
1427,310M300US40140,2017,1344956,1056705,288251
1428,310M300US40220,2017,130863,93815,37048
1430,310M300US40340,2017,85994,70451,15543
1431,310M300US40380,2017,433400,327462,105938
1432,310M300US40420,2017,132479,102087,30392
1433,310M300US40580,2017,57083,39339,17744
1434,310M300US40660,2017,36927,27842,9085
1438,310M300US40900,2017,829772,643208,186564
1439,310M300US40980,2017,80958,56502,24456
1440,310M300US41060,2017,76342,63475,12867
1441,310M300US41100,2017,56139,39083,17056
1442,310M300US41140,2017,47135,34561,12574
1443,310M300US41180,2017,1119347,869205,250142
1445,310M300US41420,2017,144978,109402,35576
1446,310M300US41500,2017,125518,103830,21688
1447,310M300US41540,2017,154115,111435,42680
1448,310M300US41620,2017,396869,342581,54288
1449,310M300US41660,2017,42667,33245,9422
1450,310M300US41700,2017,810473,650245,160228
1451,310M300US41740,2017,1126419,922857,203562
1453,310M300US41860,2017,1694362,1392116,302246
1454,310M300US41900,2017,39954,15739,24215
1455,310M300US41940,2017,651006,555940,95066
1456,310M300US41980,2017,753677,431413,322264
1457,310M300US42020,2017,104544,78261,26283
1458,310M300US42100,2017,95940,76656,19284
1459,310M300US42140,2017,60904,44305,16599
1460,310M300US42200,2017,147466,119153,28313
1461,310M300US42220,2017,188829,145193,43636
1462,310M300US42340,2017,142195,112377,29818
1463,310M300US42540,2017,223630,162208,61422
1465,310M300US42660,2017,1490337,1236712,253625
1466,310M300US42680,2017,58044,33370,24674
1467,310M300US42700,2017,42948,20499,22449
1471,310M300US43100,2017,48347,38012,10335
1473,310M300US43300,2017,49176,37600,11576
1475,310M300US43340,2017,172294,122645,49649
1476,310M300US43420,2017,48939,33865,15074
1477,310M300US43580,2017,65877,52739,13138
1478,310M300US43620,2017,102654,86501,16153
1480,310M300US43780,2017,119873,92705,27168
1481,310M300US43900,2017,126242,94531,31711
1482,310M300US44060,2017,224113,170085,54028
1483,310M300US44100,2017,89434,67869,21565
1484,310M300US44140,2017,238781,174196,64585
1485,310M300US44180,2017,183438,139217,44221
1486,310M300US44220,2017,54026,38907,15119
1487,310M300US44300,2017,58629,45885,12744
1489,310M300US44420,2017,50325,37243,13082
1492,310M300US44700,2017,226624,180840,45784
1493,310M300US44940,2017,41878,31038,10840
1495,310M300US45060,2017,257704,194234,63470
1497,310M300US45220,2017,147734,115620,32114
1498,310M300US45300,2017,1209519,874645,334874
1499,310M300US45460,2017,65394,46888,18506
1500,310M300US45500,2017,55934,39532,16402
1501,310M300US45540,2017,55097,16668,38429
1502,310M300US45780,2017,245035,186517,58518
1503,310M300US45820,2017,96822,73863,22959
1506,310M300US45940,2017,128757,100659,28098
1508,310M300US46060,2017,403574,295670,107904
1510,310M300US46140,2017,379757,295048,84709
1512,310M300US46220,2017,84249,63461,20788
1514,310M300US46340,2017,77292,57998,19294
1516,310M300US46520,2017,312625,254192,58433
1517,310M300US46540,2017,113323,81702,31621
1518,310M300US46660,2017,53619,37490,16129
1519,310M300US46700,2017,151127,120429,30698
1520,310M300US47020,2017,35635,26886,8749
1521,310M300US47220,2017,50696,37902,12794
1522,310M300US47260,2017,641881,517570,124311
1523,310M300US47300,2017,137576,110081,27495
1524,310M300US47380,2017,97310,76499,20811
1525,310M300US47460,2017,24256,17944,6312
1526,310M300US47580,2017,70479,53648,16831
1528,310M300US47900,2017,2203717,1890675,313042
1529,310M300US47940,2017,67711,52711,15000
1531,310M300US48060,2017,41548,30680,10868
1532,310M300US48140,2017,55084,43811,11273
1533,310M300US48260,2017,48242,34021,14221
1534,310M300US48300,2017,42468,32163,10305
1535,310M300US48540,2017,51143,34554,16589
1537,310M300US48620,2017,246524,191327,55197
1538,310M300US48660,2017,55426,41566,13860
1539,310M300US48700,2017,46122,33636,12486
1540,310M300US48900,2017,117982,87636,30346
1542,310M300US49020,2017,51174,40007,11167
1543,310M300US49180,2017,263215,192951,70264
1546,310M300US49340,2017,352356,269493,82863
1547,310M300US49420,2017,82107,63860,18247
1548,310M300US49620,2017,171781,133947,37834
1549,310M300US49660,2017,231423,162440,68983
1550,310M300US49700,2017,58173,44131,14042
1551,310M300US49740,2017,74620,52467,22153
1554,310M400US10180,2018,61527,47972,13555
1556,310M400US10380,2018,109531,55437,54094
1557,310M400US10420,2018,287044,220484,66560
1559,310M400US10500,2018,56348,42650,13698
1560,310M400US10540,2018,48464,36042,12422
1561,310M400US10580,2018,353746,272210,81536
1563,310M400US10740,2018,358493,264566,93927
1564,310M400US10780,2018,55127,39185,15942
1565,310M400US10900,2018,320501,243515,76986
1566,310M400US11020,2018,51096,36745,14351
1567,310M400US11100,2018,98518,80297,18221
1568,310M400US11180,2018,37290,31278,6012
1569,310M400US11260,2018,137483,117901,19582
1570,310M400US11460,2018,143072,116621,26451
1571,310M400US11500,2018,44264,31063,13201
1572,310M400US11540,2018,94810,75867,18943
1573,310M400US11640,2018,64093,32297,31796
1574,310M400US11700,2018,191889,135919,55970
1578,310M400US12020,2018,79945,64589,15356
1579,310M400US12060,2018,2137280,1780032,357248
1580,310M400US12100,2018,96981,74239,22742
1582,310M400US12220,2018,59336,44030,15306
1583,310M400US12260,2018,214107,158935,55172
1585,310M400US12420,2018,786341,681509,104832
1586,310M400US12540,2018,273167,214415,58752
1587,310M400US12580,2018,1054226,842592,211634
1588,310M400US12620,2018,61765,43838,17927
1589,310M400US12700,2018,86671,60541,26130
1590,310M400US12940,2018,301509,231791,69718
1591,310M400US12980,2018,53914,39905,14009
1592,310M400US13020,2018,44469,30652,13817
1593,310M400US13140,2018,145130,107362,37768
1595,310M400US13220,2018,48632,32616,16016
1596,310M400US13380,2018,87080,67226,19854
1597,310M400US13460,2018,79950,59373,20577
1598,310M400US13740,2018,71787,56013,15774
1599,310M400US13780,2018,95740,69447,26293
1600,310M400US13820,2018,435832,321407,114425
1601,310M400US13900,2018,56382,45668,10714
1602,310M400US13980,2018,68412,47285,21127
1603,310M400US14010,2018,73580,57998,15582
1604,310M400US14020,2018,65571,52766,12805
1605,310M400US14100,2018,34470,25103,9367
1607,310M400US14260,2018,268289,210651,57638
1608,310M400US14460,2018,1847798,1492146,355652
1609,310M400US14500,2018,128295,106497,21798
1610,310M400US14540,2018,67424,51714,15710
1614,310M400US14740,2018,105411,78837,26574
1615,310M400US14860,2018,345634,283507,62127
1616,310M400US15180,2018,124812,93421,31391
1617,310M400US15260,2018,47266,33987,13279
1618,310M400US15380,2018,480106,351615,128491
1619,310M400US15500,2018,64700,48724,15976
1620,310M400US15540,2018,87329,70864,16465
1621,310M400US15680,2018,41239,33924,7315
1622,310M400US15940,2018,163626,120502,43124
1623,310M400US15980,2018,281222,179748,101474
1624,310M400US16020,2018,34368,25882,8486
1625,310M400US16060,2018,51205,36906,14299
1626,310M400US16180,2018,23099,17635,5464
1627,310M400US16220,2018,32240,26561,5679
1628,310M400US16300,2018,109191,86674,22517
1630,310M400US16540,2018,59834,45361,14473
1631,310M400US16580,2018,96449,75356,21093
1632,310M400US16620,2018,90728,60564,30164
1633,310M400US16700,2018,294424,233508,60916
1634,310M400US16740,2018,960297,784252,176045
1635,310M400US16820,2018,88765,67517,21248
1636,310M400US16860,2018,221133,167501,53632
1637,310M400US16940,2018,39678,29939,9739
1638,310M400US16980,2018,3538101,2842894,695207
1639,310M400US17020,2018,88636,63530,25106
1641,310M400US17140,2018,862535,682868,179667
1644,310M400US17300,2018,104502,81190,23312
1646,310M400US17420,2018,46778,36355,10423
1647,310M400US17460,2018,866039,649730,216309
1648,310M400US17660,2018,64955,47282,17673
1649,310M400US17780,2018,94615,78006,16609
1650,310M400US17820,2018,271694,221742,49952
1651,310M400US17860,2018,72217,60638,11579
1652,310M400US17900,2018,315092,245697,69395
1653,310M400US17980,2018,114607,81691,32916
1654,310M400US18020,2018,31891,24987,6904
1655,310M400US18140,2018,801805,649603,152202
1660,310M400US18580,2018,161693,128339,33354
1661,310M400US18700,2018,35520,27577,7943
1662,310M400US18880,2018,108340,82471,25869
1664,310M400US19060,2018,37893,25798,12095
1665,310M400US19100,2018,2623878,2249398,374480
1666,310M400US19140,2018,51023,38873,12150
1667,310M400US19180,2018,30166,20404,9762
1669,310M400US19300,2018,83501,62001,21500
1670,310M400US19340,2018,153865,115551,38314
1671,310M400US19380,2018,331426,249699,81727
1672,310M400US19460,2018,57863,41451,16412
1673,310M400US19500,2018,44562,33007,11555
1674,310M400US19660,2018,259697,171898,87799
1675,310M400US19740,2018,1131410,956664,174746
1676,310M400US19780,2018,255055,211792,43263
1677,310M400US19820,2018,1710686,1279166,431520
1678,310M400US20020,2018,55431,37531,17900
1679,310M400US20100,2018,67841,49902,17939
1681,310M400US20220,2018,38501,30017,8484
1682,310M400US20260,2018,117226,84970,32256
1684,310M400US20500,2018,225699,184222,41477
1685,310M400US20700,2018,55109,41625,13484
1686,310M400US20740,2018,66796,51818,14978
1687,310M400US20940,2018,41764,32166,9598
1689,310M400US21060,2018,57098,41653,15445
1690,310M400US21140,2018,73660,61287,12373
1691,310M400US21300,2018,34325,24217,10108
1692,310M400US21340,2018,271122,215330,55792
1693,310M400US21420,2018,22998,18544,4454
1694,310M400US21500,2018,109797,80658,29139
1695,310M400US21660,2018,156072,114294,41778
1697,310M400US21780,2018,128680,98116,30564
1698,310M400US21820,2018,36378,31021,5357
1699,310M400US22020,2018,99306,84132,15174
1702,310M400US22140,2018,43707,31206,12501
1703,310M400US22180,2018,146760,112961,33799
1704,310M400US22220,2018,205278,167222,38056
1706,310M400US22380,2018,47275,38371,8904
1707,310M400US22420,2018,169469,119687,49782
1708,310M400US22500,2018,75826,53826,22000
1709,310M400US22520,2018,59932,40365,19567
1710,310M400US22540,2018,41009,31420,9589
1712,310M400US22660,2018,139382,113639,25743
1714,310M400US22900,2018,108790,77738,31052
1715,310M400US23060,2018,172311,136780,35531
1717,310M400US23420,2018,309519,244168,65351
1718,310M400US23460,2018,38625,26857,11768
1719,310M400US23540,2018,105161,80722,24439
1720,310M400US23580,2018,64990,51173,13817
1722,310M400US23900,2018,39570,29624,9946
1723,310M400US24020,2018,51996,38659,13337
1725,310M400US24140,2018,49019,36152,12867
1726,310M400US24220,2018,43081,34455,8626
1727,310M400US24260,2018,32687,25305,7382
1728,310M400US24300,2018,61848,45964,15884
1729,310M400US24340,2018,397199,316491,80708
1730,310M400US24420,2018,37059,23306,13753
1731,310M400US24500,2018,35558,26478,9080
1732,310M400US24540,2018,107929,92094,15835
1733,310M400US24580,2018,129113,101167,27946
1736,310M400US24660,2018,302101,232284,69817
1737,310M400US24780,2018,69288,54244,15044
1738,310M400US24860,2018,344664,262705,81959
1740,310M400US25020,2018,25441,10401,15040
1741,310M400US25060,2018,155026,111842,43184
1742,310M400US25180,2018,102106,78917,23189
1743,310M400US25220,2018,47401,35021,12380
1744,310M400US25260,2018,43727,35058,8669
1745,310M400US25420,2018,233591,185020,48571
1746,310M400US25500,2018,47987,37494,10493
1747,310M400US25540,2018,470651,367483,103168
1748,310M400US25620,2018,54084,40043,14041
1751,310M400US25860,2018,145158,110327,34831
1753,310M400US25940,2018,84041,58135,25906
1754,310M400US25980,2018,31296,25384,5912
1757,310M400US26140,2018,62293,28450,33843
1758,310M400US26300,2018,40407,27264,13143
1759,310M400US26380,2018,73749,54617,19132
1760,310M400US26420,2018,2359266,2013186,346080
1761,310M400US26580,2018,136769,87917,48852
1762,310M400US26620,2018,185056,143300,41756
1765,310M400US26820,2018,50354,40811,9543
1767,310M400US26900,2018,783345,630711,152634
1768,310M400US26980,2018,69686,58159,11527
1769,310M400US27060,2018,40250,32850,7400
1770,310M400US27100,2018,62598,45359,17239
1771,310M400US27140,2018,210166,167110,43056
1772,310M400US27180,2018,50548,36343,14205
1773,310M400US27260,2018,575423,446991,128432
1774,310M400US27340,2018,66834,54809,12025
1776,310M400US27500,2018,64632,49640,14992
1778,310M400US27620,2018,57053,43903,13150
1779,310M400US27740,2018,85430,60271,25159
1780,310M400US27780,2018,56483,38014,18469
1781,310M400US27860,2018,52335,39325,13010
1782,310M400US27900,2018,71145,54519,16626
1783,310M400US27980,2018,52851,42679,10172
1784,310M400US28020,2018,132841,102498,30343
1786,310M400US28100,2018,40642,29419,11223
1787,310M400US28140,2018,835092,675841,159251
1790,310M400US28420,2018,98988,78073,20915
1792,310M400US28660,2018,152160,121610,30550
1793,310M400US28700,2018,125768,81491,44277
1794,310M400US28740,2018,69154,52828,16326
1796,310M400US28940,2018,344657,254940,89717
1797,310M400US29020,2018,35139,25682,9457
1798,310M400US29100,2018,56157,43781,12376
1799,310M400US29180,2018,184357,141902,42455
1800,310M400US29200,2018,81884,67273,14611
1802,310M400US29340,2018,80385,59122,21263
1804,310M400US29420,2018,90270,51332,38938
1805,310M400US29460,2018,241171,167238,73933
1806,310M400US29540,2018,202490,160762,41728
1807,310M400US29620,2018,186832,143589,43243
1808,310M400US29700,2018,75300,63169,12131
1809,310M400US29740,2018,80409,58233,22176
1810,310M400US29820,2018,808605,634650,173955
1812,310M400US29940,2018,48907,41455,7452
1813,310M400US30020,2018,44611,34454,10157
1814,310M400US30140,2018,54522,41348,13174
1815,310M400US30300,2018,25267,17586,7681
1816,310M400US30340,2018,44897,33344,11553
1817,310M400US30460,2018,204420,164958,39462
1818,310M400US30620,2018,41204,30413,10791
1819,310M400US30700,2018,132621,109929,22692
1820,310M400US30780,2018,284383,217526,66857
1821,310M400US30860,2018,43423,36297,7126
1823,310M400US30980,2018,76416,58776,17640
1824,310M400US31020,2018,43279,31344,11935
1825,310M400US31080,2018,4354302,3596534,757768
1826,310M400US31140,2018,507467,395847,111620
1827,310M400US31180,2018,120125,99871,20254
1830,310M400US31340,2018,103276,75983,27293
1831,310M400US31420,2018,84705,57860,26845
1832,310M400US31460,2018,44484,33177,11307
1833,310M400US31540,2018,275594,228112,47482
1834,310M400US31700,2018,161649,130005,31644
1835,310M400US31740,2018,35912,31046,4866
1837,310M400US31860,2018,39263,31982,7281
1838,310M400US31900,2018,48105,32959,15146
1845,310M400US32420,2018,37540,15843,21697
1846,310M400US32580,2018,237323,187289,50034
1848,310M400US32780,2018,89787,64386,25401
1849,310M400US32820,2018,504141,393166,110975
1850,310M400US32900,2018,79487,63319,16168
1852,310M400US33100,2018,2143067,1655612,487455
1853,310M400US33140,2018,43122,32055,11067
1854,310M400US33220,2018,34091,23954,10137
1855,310M400US33260,2018,59179,51039,8140
1856,310M400US33340,2018,634398,492314,142084
1857,310M400US33460,2018,1386468,1140881,245587
1859,310M400US33540,2018,50401,42504,7897
1860,310M400US33660,2018,158627,112003,46624
1861,310M400US33700,2018,175171,138194,36977
1862,310M400US33740,2018,64791,46179,18612
1863,310M400US33780,2018,61586,44727,16859
1864,310M400US33860,2018,142728,107401,35327
1866,310M400US34060,2018,53173,41877,11296
1867,310M400US34100,2018,43772,30410,13362
1871,310M400US34580,2018,48474,34783,13691
1872,310M400US34620,2018,45311,33556,11755
1873,310M400US34740,2018,67196,49836,17360
1875,310M400US34820,2018,187932,122225,65707
1877,310M400US34900,2018,47315,36663,10652
1878,310M400US34940,2018,144172,90975,53197
1879,310M400US34980,2018,730709,607942,122767
1880,310M400US35100,2018,49527,32664,16863
1882,310M400US35300,2018,335539,258968,76571
1883,310M400US35380,2018,482442,366759,115683
1885,310M400US35620,2018,7282923,5774975,1507948
1886,310M400US35660,2018,64783,49402,15381
1887,310M400US35840,2018,334535,206584,127951
1889,310M400US35980,2018,108098,83981,24117
1891,310M400US36100,2018,143441,82595,60846
1892,310M400US36140,2018,39208,27910,11298
1893,310M400US36220,2018,54326,47318,7008
1894,310M400US36260,2018,211332,177854,33478
1896,310M400US36420,2018,522039,420349,101690
1898,310M400US36500,2018,110713,85736,24977
1899,310M400US36540,2018,362764,294147,68617
1902,310M400US36740,2018,876502,701127,175375
1903,310M400US36780,2018,71332,54162,17170
1905,310M400US36980,2018,46687,34236,12451
1907,310M400US37100,2018,271980,218958,53022
1910,310M400US37340,2018,226363,151455,74908
1911,310M400US37460,2018,80447,59398,21049
1912,310M400US37620,2018,38995,26434,12561
1913,310M400US37860,2018,182711,138577,44134
1914,310M400US37900,2018,147607,108641,38966
1915,310M400US37980,2018,2285651,1792843,492808
1916,310M400US38060,2018,1730400,1359259,371141
1917,310M400US38220,2018,32467,21242,11225
1919,310M400US38300,2018,1013812,751525,262287
1920,310M400US38340,2018,55212,39757,15455
1922,310M400US38540,2018,30635,23614,7021
1923,310M400US38660,2018,107565,56293,51272
1925,310M400US38860,2018,228248,178844,49404
1926,310M400US38900,2018,954947,765047,189900
1927,310M400US38940,2018,181838,117651,64187
1930,310M400US39140,2018,100836,61116,39720
1931,310M400US39300,2018,621705,466432,155273
1932,310M400US39340,2018,174426,156006,18420
1933,310M400US39380,2018,64954,44690,20264
1934,310M400US39460,2018,74975,37641,37334
1936,310M400US39540,2018,76808,58314,18494
1937,310M400US39580,2018,504854,429475,75379
1938,310M400US39660,2018,58509,45794,12715
1939,310M400US39740,2018,157006,122308,34698
1940,310M400US39820,2018,68198,46154,22044
1941,310M400US39900,2018,187724,147818,39906
1943,310M400US40060,2018,497416,393928,103488
1945,310M400US40140,2018,1366750,1079723,287027
1946,310M400US40220,2018,126687,91986,34701
1948,310M400US40340,2018,88644,71961,16683
1949,310M400US40380,2018,430682,319981,110701
1950,310M400US40420,2018,133049,101743,31306
1951,310M400US40580,2018,58844,43555,15289
1952,310M400US40660,2018,34672,22918,11754
1956,310M400US40900,2018,835453,648399,187054
1957,310M400US40980,2018,78740,54871,23869
1958,310M400US41060,2018,74937,59296,15641
1959,310M400US41100,2018,59863,40522,19341
1960,310M400US41140,2018,46816,36407,10409
1961,310M400US41180,2018,1137478,879250,258228
1963,310M400US41420,2018,150729,116166,34563
1964,310M400US41500,2018,126299,102869,23430
1965,310M400US41540,2018,161305,115254,46051
1966,310M400US41620,2018,402242,341919,60323
1967,310M400US41660,2018,43938,33659,10279
1968,310M400US41700,2018,823888,653646,170242
1969,310M400US41740,2018,1130911,926184,204727
1971,310M400US41860,2018,1698978,1397590,301388
1972,310M400US41900,2018,40432,18588,21844
1973,310M400US41940,2018,663870,566220,97650
1974,310M400US41980,2018,749522,436533,312989
1975,310M400US42020,2018,106198,77197,29001
1976,310M400US42100,2018,94994,76126,18868
1977,310M400US42140,2018,62707,45225,17482
1978,310M400US42200,2018,146224,117260,28964
1979,310M400US42220,2018,187434,144681,42753
1980,310M400US42340,2018,142909,114629,28280
1981,310M400US42540,2018,227731,166581,61150
1983,310M400US42660,2018,1526210,1265863,260347
1984,310M400US42680,2018,57636,32961,24675
1985,310M400US42700,2018,40573,21200,19373
1989,310M400US43100,2018,46308,35161,11147
1992,310M400US43300,2018,48963,36533,12430
1994,310M400US43340,2018,171540,124960,46580
1995,310M400US43420,2018,49751,33194,16557
1996,310M400US43580,2018,65930,53821,12109
1997,310M400US43620,2018,102650,86455,16195
1999,310M400US43780,2018,128578,101211,27367
2000,310M400US43900,2018,127652,98303,29349
2001,310M400US44060,2018,229018,171161,57857
2002,310M400US44100,2018,88301,66340,21961
2003,310M400US44140,2018,237580,174626,62954
2004,310M400US44180,2018,192513,140545,51968
2005,310M400US44220,2018,55327,39511,15816
2006,310M400US44300,2018,58514,45400,13114
2008,310M400US44420,2018,50045,36814,13231
2011,310M400US44700,2018,231917,185532,46385
2012,310M400US44940,2018,40396,31323,9073
2014,310M400US45060,2018,257443,190955,66488
2016,310M400US45220,2018,146351,113626,32725
2017,310M400US45300,2018,1227325,890778,336547
2018,310M400US45460,2018,67747,52681,15066
2019,310M400US45500,2018,56610,39648,16962
2020,310M400US45540,2018,62854,21822,41032
2021,310M400US45780,2018,245652,185143,60509
2022,310M400US45820,2018,95364,70724,24640
2025,310M400US45940,2018,132980,104004,28976
2027,310M400US46060,2018,402323,289459,112864
2029,310M400US46140,2018,381588,297287,84301
2031,310M400US46220,2018,87597,66637,20960
2032,310M400US46300,2018,40130,30537,9593
2033,310M400US46340,2018,77330,57268,20062
2035,310M400US46520,2018,308208,255158,53050
2036,310M400US46540,2018,112800,81466,31334
2037,310M400US46660,2018,53680,36316,17364
2038,310M400US46700,2018,152291,124492,27799
2039,310M400US47020,2018,34730,25979,8751
2040,310M400US47220,2018,50034,36306,13728
2041,310M400US47260,2018,654475,519844,134631
2042,310M400US47300,2018,139197,109715,29482
2043,310M400US47380,2018,97387,74788,22599
2044,310M400US47460,2018,23893,17430,6463
2045,310M400US47580,2018,71511,56791,14720
2047,310M400US47900,2018,2234559,1913253,321306
2048,310M400US47940,2018,68384,52923,15461
2050,310M400US48060,2018,44657,34514,10143
2051,310M400US48140,2018,56245,43839,12406
2052,310M400US48260,2018,51680,34506,17174
2053,310M400US48300,2018,47855,37238,10617
2054,310M400US48540,2018,52435,35657,16778
2056,310M400US48620,2018,248799,193692,55107
2057,310M400US48660,2018,54429,41170,13259
2058,310M400US48700,2018,44585,32282,12303
2059,310M400US48900,2018,120886,89458,31428
2061,310M400US49020,2018,53715,41106,12609
2062,310M400US49180,2018,270772,199874,70898
2065,310M400US49340,2018,353402,275648,77754
2066,310M400US49420,2018,83320,64232,19088
2067,310M400US49620,2018,173958,134217,39741
2068,310M400US49660,2018,227477,158062,69415
2069,310M400US49700,2018,58180,43329,14851
2070,310M400US49740,2018,74532,52800,21732
2073,310M500US10180,2019,61750,48218,13532
2075,310M500US10380,2019,101568,47957,53611
2076,310M500US10420,2019,285647,217528,68119
2078,310M500US10500,2019,54128,37237,16891
2079,310M500US10540,2019,49407,36777,12630
2080,310M500US10580,2019,362502,277828,84674
2082,310M500US10740,2019,354359,270611,83748
2083,310M500US10780,2019,55591,40540,15051
2084,310M500US10900,2019,322301,244408,77893
2085,310M500US11020,2019,52497,36743,15754
2086,310M500US11100,2019,98606,77723,20883
2087,310M500US11180,2019,50253,41031,9222
2088,310M500US11260,2019,137934,114632,23302
2089,310M500US11460,2019,141680,116770,24910
2090,310M500US11500,2019,44636,31064,13572
2091,310M500US11540,2019,94937,75327,19610
2092,310M500US11640,2019,65208,33408,31800
2093,310M500US11700,2019,193451,137552,55899
2097,310M500US12020,2019,82655,66268,16387
2098,310M500US12060,2019,2189294,1818619,370675
2099,310M500US12100,2019,101975,74859,27116
2101,310M500US12220,2019,64448,52250,12198
2102,310M500US12260,2019,211969,156146,55823
2104,310M500US12420,2019,818084,708773,109311
2105,310M500US12540,2019,272888,210998,61890
2106,310M500US12580,2019,1062901,842653,220248
2107,310M500US12620,2019,64096,46398,17698
2108,310M500US12700,2019,96509,68793,27716
2109,310M500US12940,2019,305441,235052,70389
2110,310M500US12980,2019,53827,39087,14740
2111,310M500US13020,2019,44887,30924,13963
2112,310M500US13140,2019,142135,109001,33134
2114,310M500US13220,2019,49117,31783,17334
2115,310M500US13380,2019,88794,66683,22111
2116,310M500US13460,2019,76528,56535,19993
2117,310M500US13740,2019,78108,61583,16525
2118,310M500US13780,2019,99300,69937,29363
2119,310M500US13820,2019,428665,323857,104808
2120,310M500US13900,2019,52396,41556,10840
2121,310M500US13980,2019,62114,45570,16544
2122,310M500US14010,2019,65118,48701,16417
2123,310M500US14020,2019,62229,48483,13746
2124,310M500US14100,2019,33738,25282,8456
2126,310M500US14260,2019,275681,218884,56797
2127,310M500US14460,2019,1855763,1495112,360651
2128,310M500US14500,2019,131854,109236,22618
2129,310M500US14540,2019,66318,51790,14528
2132,310M500US14740,2019,107525,84145,23380
2133,310M500US14860,2019,340557,276317,64240
2134,310M500US15180,2019,129307,99370,29937
2135,310M500US15260,2019,47730,33455,14275
2136,310M500US15380,2019,488951,357563,131388
2137,310M500US15500,2019,64316,48078,16238
2138,310M500US15540,2019,89859,71868,17991
2139,310M500US15680,2019,40320,32428,7892
2140,310M500US15940,2019,165718,123376,42342
2141,310M500US15980,2019,286887,180445,106442
2142,310M500US16020,2019,38214,29348,8866
2143,310M500US16060,2019,56518,41554,14964
2144,310M500US16180,2019,22703,15949,6754
2145,310M500US16220,2019,33044,26786,6258
2146,310M500US16300,2019,112373,88437,23936
2148,310M500US16540,2019,60260,44478,15782
2149,310M500US16580,2019,88700,69011,19689
2150,310M500US16620,2019,109452,72008,37444
2151,310M500US16700,2019,303976,243259,60717
2152,310M500US16740,2019,982241,800541,181700
2153,310M500US16820,2019,87274,67894,19380
2154,310M500US16860,2019,222950,165578,57372
2155,310M500US16940,2019,41739,32005,9734
2156,310M500US16980,2019,3539174,2824070,715104
2157,310M500US17020,2019,77651,56045,21606
2159,310M500US17140,2019,878645,691123,187522
2161,310M500US17300,2019,115195,90385,24810
2163,310M500US17420,2019,46936,35049,11887
2164,310M500US17460,2019,872626,645118,227508
2165,310M500US17660,2019,65283,49277,16006
2166,310M500US17780,2019,94597,79207,15390
2167,310M500US17820,2019,275778,222991,52787
2168,310M500US17860,2019,80127,65561,14566
2169,310M500US17900,2019,317998,242258,75740
2170,310M500US17980,2019,119728,88982,30746
2171,310M500US18020,2019,30383,24006,6377
2172,310M500US18140,2019,817086,670929,146157
2177,310M500US18580,2019,153066,120245,32821
2178,310M500US18700,2019,37378,29520,7858
2179,310M500US18880,2019,102572,77682,24890
2181,310M500US19060,2019,36430,22062,14368
2182,310M500US19100,2019,2635017,2250291,384726
2183,310M500US19140,2019,50267,39747,10520
2184,310M500US19180,2019,31154,21752,9402
2186,310M500US19300,2019,82325,56920,25405
2187,310M500US19340,2019,155389,116653,38736
2188,310M500US19430,2019,332258,249813,82445
2189,310M500US19460,2019,59315,40620,18695
2190,310M500US19500,2019,42741,28009,14732
2191,310M500US19660,2019,263915,175370,88545
2192,310M500US19740,2019,1152457,974983,177474
2193,310M500US19780,2019,280056,229158,50898
2194,310M500US19820,2019,1720610,1298687,421923
2195,310M500US20020,2019,56795,39648,17147
2196,310M500US20100,2019,68023,50504,17519
2199,310M500US20220,2019,38345,30706,7639
2200,310M500US20260,2019,124913,90962,33951
2201,310M500US20500,2019,255271,202376,52895
2202,310M500US20700,2019,56274,43768,12506
2203,310M500US20740,2019,67096,53011,14085
2204,310M500US20940,2019,48182,35754,12428
2205,310M500US21060,2019,58590,43983,14607
2206,310M500US21140,2019,68553,53313,15240
2207,310M500US21300,2019,33490,23775,9715
2208,310M500US21340,2019,270137,217197,52940
2209,310M500US21420,2019,23683,18588,5095
2210,310M500US21500,2019,110128,81481,28647
2211,310M500US21660,2019,155696,115697,39999
2213,310M500US21780,2019,129971,101117,28854
2214,310M500US21820,2019,35556,30202,5354
2215,310M500US22020,2019,104097,88701,15396
2218,310M500US22140,2019,42561,30893,11668
2219,310M500US22180,2019,193936,149796,44140
2220,310M500US22220,2019,196683,156601,40082
2222,310M500US22380,2019,48993,38616,10377
2223,310M500US22420,2019,169247,116487,52760
2224,310M500US22500,2019,77848,56324,21524
2225,310M500US22520,2019,60837,39648,21189
2226,310M500US22540,2019,42604,32583,10021
2228,310M500US22660,2019,146638,118081,28557
2230,310M500US22900,2019,98307,68572,29735
2231,310M500US23060,2019,160462,129489,30973
2233,310M500US23420,2019,315974,244706,71268
2234,310M500US23460,2019,40053,27302,12751
2235,310M500US23540,2019,126736,93485,33251
2236,310M500US23580,2019,65625,51112,14513
2238,310M500US23900,2019,38703,29213,9490
2239,310M500US24020,2019,53686,40060,13626
2241,310M500US24140,2019,48482,35871,12611
2242,310M500US24220,2019,44724,36015,8709
2243,310M500US24260,2019,30529,24473,6056
2244,310M500US24300,2019,63644,47740,15904
2245,310M500US24340,2019,396763,315514,81249
2246,310M500US24420,2019,35206,23983,11223
2247,310M500US24500,2019,32816,24048,8768
2248,310M500US24540,2019,111298,93282,18016
2249,310M500US24580,2019,132099,102709,29390
2251,310M500US24660,2019,301529,230328,71201
2252,310M500US24780,2019,70926,54783,16143
2253,310M500US24860,2019,349480,269608,79872
2255,310M500US25020,2019,24247,10892,13355
2256,310M500US25060,2019,159081,116053,43028
2257,310M500US25180,2019,110354,82360,27994
2258,310M500US25220,2019,46526,34997,11529
2259,310M500US25260,2019,44761,36337,8424
2260,310M500US25420,2019,234365,182113,52252
2261,310M500US25500,2019,47098,37343,9755
2262,310M500US25540,2019,476867,368616,108251
2263,310M500US25620,2019,59170,45482,13688
2267,310M500US25860,2019,146324,108058,38266
2269,310M500US25940,2019,84094,56919,27175
2270,310M500US25980,2019,29973,22848,7125
2273,310M500US26140,2019,64448,33354,31094
2274,310M500US26300,2019,41743,28633,13110
2275,310M500US26380,2019,76932,56506,20426
2276,310M500US26420,2019,2436438,2073974,362464
2277,310M500US26580,2019,136687,92228,44459
2278,310M500US26620,2019,187898,148087,39811
2281,310M500US26820,2019,51152,41496,9656
2283,310M500US26900,2019,793781,634521,159260
2284,310M500US26980,2019,70169,58740,11429
2285,310M500US27060,2019,40322,31738,8584
2286,310M500US27100,2019,61403,43497,17906
2287,310M500US27140,2019,218853,171204,47649
2288,310M500US27180,2019,70379,52088,18291
2289,310M500US27260,2019,584381,459792,124589
2290,310M500US27340,2019,63604,50628,12976
2292,310M500US27500,2019,65316,49305,16011
2294,310M500US27620,2019,59727,44628,15099
2295,310M500US27740,2019,89021,64118,24903
2296,310M500US27780,2019,56490,37272,19218
2297,310M500US27860,2019,51288,38851,12437
2298,310M500US27900,2019,67167,51753,15414
2299,310M500US27980,2019,54744,42875,11869
2300,310M500US28020,2019,103196,79645,23551
2302,310M500US28100,2019,39583,30746,8837
2303,310M500US28140,2019,844310,678642,165668
2306,310M500US28420,2019,101840,80060,21780
2308,310M500US28660,2019,157088,124319,32769
2309,310M500US28700,2019,130928,90437,40491
2310,310M500US28740,2019,69376,51175,18201
2312,310M500US28940,2019,347927,253716,94211
2313,310M500US29020,2019,34151,24709,9442
2314,310M500US29100,2019,56515,44603,11912
2315,310M500US29180,2019,184313,137729,46584
2316,310M500US29200,2019,89655,71838,17817
2318,310M500US29340,2019,79505,60275,19230
2320,310M500US29420,2019,91095,52551,38544
2321,310M500US29460,2019,238629,163627,75002
2322,310M500US29540,2019,204701,161668,43033
2323,310M500US29620,2019,215854,165538,50316
2324,310M500US29700,2019,76326,66532,9794
2325,310M500US29740,2019,79094,56327,22767
2326,310M500US29820,2019,813607,631544,182063
2328,310M500US29940,2019,48508,41860,6648
2329,310M500US30020,2019,44127,34247,9880
2331,310M500US30140,2019,53861,42533,11328
2332,310M500US30300,2019,26915,19548,7367
2333,310M500US30340,2019,45924,35202,10722
2334,310M500US30460,2019,205914,164784,41130
2335,310M500US30620,2019,40460,30268,10192
2336,310M500US30700,2019,135008,111969,23039
2337,310M500US30780,2019,288565,219094,69471
2338,310M500US30860,2019,45043,37925,7118
2340,310M500US30980,2019,102964,77714,25250
2341,310M500US31020,2019,42790,28654,14136
2342,310M500US31080,2019,4372678,3603934,768744
2343,310M500US31140,2019,495246,385733,109513
2344,310M500US31180,2019,121838,100024,21814
2347,310M500US31340,2019,102879,75689,27190
2348,310M500US31420,2019,85864,62954,22910
2349,310M500US31460,2019,44387,34789,9598
2350,310M500US31540,2019,279014,228741,50273
2351,310M500US31700,2019,162588,131611,30977
2352,310M500US31740,2019,46526,39284,7242
2354,310M500US31860,2019,39791,32192,7599
2355,310M500US31900,2019,49812,36041,13771
2361,310M500US32420,2019,37341,17998,19343
2362,310M500US32580,2019,247544,199180,48364
2364,310M500US32780,2019,87800,59054,28746
2365,310M500US32820,2019,505048,402018,103030
2366,310M500US32900,2019,80645,65938,14707
2368,310M500US33100,2019,2187192,1693710,493482
2369,310M500US33140,2019,43100,32990,10110
2370,310M500US33220,2019,34350,24775,9575
2371,310M500US33260,2019,61159,53944,7215
2372,310M500US33340,2019,635351,490012,145339
2373,310M500US33460,2019,1396025,1141706,254319
2375,310M500US33540,2019,50853,41010,9843
2376,310M500US33660,2019,161217,115814,45403
2377,310M500US33700,2019,174698,136681,38017
2378,310M500US33740,2019,77194,54727,22467
2379,310M500US33780,2019,60875,43578,17297
2380,310M500US33860,2019,145250,111369,33881
2382,310M500US34060,2019,53129,41503,11626
2383,310M500US34100,2019,55874,39821,16053
2387,310M500US34580,2019,49043,34959,14084
2388,310M500US34620,2019,45640,32032,13608
2389,310M500US34740,2019,66148,46234,19914
2391,310M500US34820,2019,198645,129114,69531
2393,310M500US34900,2019,48107,36569,11538
2394,310M500US34940,2019,140578,85510,55068
2395,310M500US34980,2019,733787,612235,121552
2396,310M500US35100,2019,52345,38561,13784
2398,310M500US35300,2019,329006,250971,78035
2399,310M500US35380,2019,485267,369415,115852
2401,310M500US35620,2019,7102817,5630455,1472362
2402,310M500US35660,2019,61809,45508,16301
2403,310M500US35840,2019,332582,200164,132418
2405,310M500US35980,2019,109752,86534,23218
2407,310M500US36100,2019,145622,84182,61440
2408,310M500US36140,2019,40939,27935,13004
2409,310M500US36220,2019,53155,46543,6612
2410,310M500US36260,2019,218724,184685,34039
2412,310M500US36420,2019,523919,417486,106433
2414,310M500US36500,2019,112909,86311,26598
2415,310M500US36540,2019,367037,300651,66386
2418,310M500US36740,2019,889822,714873,174949
2419,310M500US36780,2019,71238,54412,16826
2421,310M500US36980,2019,48419,34731,13688
2422,310M500US37100,2019,268524,216186,52338
2425,310M500US37340,2019,230043,152861,77182
2426,310M500US37460,2019,69195,52460,16735
2427,310M500US37620,2019,36946,25243,11703
2428,310M500US37860,2019,186805,139965,46840
2429,310M500US37900,2019,162131,116364,45767
2430,310M500US37980,2019,2323207,1820541,502666
2431,310M500US38060,2019,1765135,1381595,383540
2432,310M500US38220,2019,34290,23814,10476
2434,310M500US38300,2019,1028436,761766,266670
2435,310M500US38340,2019,53792,38428,15364
2437,310M500US38540,2019,34540,26518,8022
2438,310M500US38660,2019,80104,41229,38875
2440,310M500US38860,2019,226904,174881,52023
2441,310M500US38900,2019,964554,770820,193734
2442,310M500US38940,2019,181914,118874,63040
2445,310M500US39100,2019,241950,190181,51769
2446,310M500US39150,2019,102784,61930,40854
2447,310M500US39300,2019,627702,472467,155235
2448,310M500US39340,2019,182219,162461,19758
2449,310M500US39380,2019,66111,46195,19916
2450,310M500US39460,2019,76589,37940,38649
2452,310M500US39540,2019,78905,59399,19506
2453,310M500US39580,2019,519648,433865,85783
2454,310M500US39660,2019,56456,44271,12185
2455,310M500US39740,2019,154696,118557,36139
2457,310M500US39820,2019,72714,49596,23118
2458,310M500US39900,2019,192402,150312,42090
2460,310M500US40060,2019,491891,388264,103627
2462,310M500US40140,2019,1379706,1090582,289124
2463,310M500US40220,2019,126469,93560,32909
2465,310M500US40340,2019,92282,74848,17434
2466,310M500US40380,2019,437296,327960,109336
2467,310M500US40420,2019,133538,103403,30135
2468,310M500US40580,2019,58531,43220,15311
2469,310M500US40660,2019,35443,25766,9677
2473,310M500US40900,2019,854279,665252,189027
2474,310M500US40980,2019,79050,54711,24339
2475,310M500US41060,2019,76473,61313,15160
2476,310M500US41100,2019,63144,44694,18450
2477,310M500US41140,2019,46958,33593,13365
2478,310M500US41180,2019,1145583,880671,264912
2480,310M500US41420,2019,152285,115068,37217
2481,310M500US41500,2019,128227,105851,22376
2482,310M500US41540,2019,166834,117692,49142
2483,310M500US41620,2019,405984,349523,56461
2484,310M500US41660,2019,44657,35144,9513
2485,310M500US41700,2019,830598,672661,157937
2486,310M500US41740,2019,1132434,921545,210889
2488,310M500US41860,2019,1721576,1401122,320454
2489,310M500US41900,2019,41896,19418,22478
2490,310M500US41940,2019,662842,561748,101094
2491,310M500US41980,2019,752543,441144,311399
2492,310M500US42020,2019,106512,79239,27273
2493,310M500US42100,2019,97710,76932,20778
2494,310M500US42140,2019,62182,44145,18037
2495,310M500US42200,2019,146466,112603,33863
2496,310M500US42220,2019,190689,146898,43791
2497,310M500US42340,2019,142579,110296,32283
2498,310M500US42540,2019,230210,167707,62503
2500,310M500US42660,2019,1541245,1277711,263534
2501,310M500US42680,2019,63917,39254,24663
2502,310M500US42700,2019,43351,22636,20715
2506,310M500US43100,2019,48691,36675,12016
2509,310M500US43300,2019,49024,36249,12775
2511,310M500US43340,2019,153824,110394,43430
2512,310M500US43420,2019,51982,33174,18808
2513,310M500US43580,2019,56092,45542,10550
2514,310M500US43620,2019,107499,90689,16810
2516,310M500US43780,2019,126331,96913,29418
2517,310M500US43900,2019,121256,90814,30442
2518,310M500US44060,2019,229880,169628,60252
2519,310M500US44100,2019,88394,64825,23569
2520,310M500US44140,2019,270899,201592,69307
2521,310M500US44180,2019,198019,142562,55457
2522,310M500US44220,2019,54406,38324,16082
2523,310M500US44300,2019,58963,47993,10970
2525,310M500US44420,2019,51142,37362,13780
2528,310M500US44700,2019,230241,184135,46106
2529,310M500US44940,2019,56459,41021,15438
2531,310M500US45060,2019,255844,191189,64655
2533,310M500US45220,2019,152648,118134,34514
2534,310M500US45300,2019,1228481,893090,335391
2535,310M500US45460,2019,72899,53205,19694
2536,310M500US45500,2019,55028,39206,15822
2537,310M500US45540,2019,59458,17812,41646
2538,310M500US45780,2019,268089,199178,68911
2539,310M500US45820,2019,95552,73124,22428
2542,310M500US45940,2019,130851,99881,30970
2544,310M500US46060,2019,410404,299259,111145
2546,310M500US46140,2019,387176,303656,83520
2548,310M500US46220,2019,90861,67021,23840
2549,310M500US46300,2019,39654,31368,8286
2550,310M500US46340,2019,78600,59871,18729
2552,310M500US46520,2019,316456,257670,58786
2553,310M500US46540,2019,115904,82488,33416
2554,310M500US46660,2019,54425,42882,11543
2555,310M500US46700,2019,150393,118133,32260
2556,310M500US47020,2019,32627,24345,8282
2557,310M500US47220,2019,51360,38395,12965
2558,310M500US47260,2019,675311,538753,136558
2559,310M500US47300,2019,144109,119333,24776
2560,310M500US47380,2019,98944,75634,23310
2561,310M500US47460,2019,23167,16833,6334
2562,310M500US47580,2019,68831,53732,15099
2564,310M500US47900,2019,2251002,1913649,337353
2565,310M500US47940,2019,67137,51124,16013
2567,310M500US48060,2019,41214,30818,10396
2568,310M500US48140,2019,67342,51462,15880
2569,310M500US48260,2019,50065,35033,15032
2570,310M500US48300,2019,44478,31937,12541
2571,310M500US48540,2019,55796,37637,18159
2573,310M500US48620,2019,246836,191660,55176
2574,310M500US48660,2019,56673,43015,13658
2575,310M500US48700,2019,44842,31847,12995
2576,310M500US48900,2019,121734,91589,30145
2578,310M500US49020,2019,50062,40109,9953
2579,310M500US49180,2019,270273,198650,71623
2582,310M500US49340,2019,363177,283976,79201
2583,310M500US49420,2019,83992,66571,17421
2584,310M500US49500,2019,30396,14096,16300
2585,310M500US49620,2019,175441,136853,38588
2586,310M500US49660,2019,230643,160008,70635
2587,310M500US49700,2019,59866,45850,14016
2588,310M500US49740,2019,74042,50238,23804
2591,310M600US10180,2021,66816,52362,14454
2593,310M600US10380,2021,107572,52791,54781
2594,310M600US10420,2021,292156,215528,76628
2596,310M600US10500,2021,57880,42133,15747
2597,310M600US10540,2021,51347,37691,13656
2598,310M600US10580,2021,378258,283679,94579
2600,310M600US10740,2021,376596,280105,96491
2601,310M600US10780,2021,55249,40518,14731
2602,310M600US10900,2021,337283,257625,79658
2603,310M600US11020,2021,49795,34310,15485
2604,310M600US11100,2021,104421,81301,23120
2605,310M600US11180,2021,49702,39664,10038
2606,310M600US11260,2021,150581,124474,26107
2607,310M600US11460,2021,149133,121370,27763
2608,310M600US11500,2021,44631,29394,15237
2609,310M600US11540,2021,98164,77647,20517
2610,310M600US11640,2021,61581,31700,29881
2611,310M600US11700,2021,185423,126681,58742
2614,310M600US12020,2021,87263,70262,17001
2615,310M600US12060,2021,2277482,1886342,391140
2616,310M600US12100,2021,112299,83738,28561
2618,310M600US12220,2021,67358,54023,13335
2619,310M600US12260,2021,222266,162209,60057
2621,310M600US12420,2021,955207,820620,134587
2622,310M600US12540,2021,282963,218824,64139
2623,310M600US12580,2021,1117510,888169,229341
2624,310M600US12620,2021,65441,47064,18377
2626,310M600US12700,2021,104733,72544,32189
2627,310M600US12940,2021,328816,249957,78859
2628,310M600US12980,2021,53482,38729,14753
2629,310M600US13020,2021,45487,30412,15075
2630,310M600US13140,2021,148489,113683,34806
2632,310M600US13220,2021,46282,26538,19744
2633,310M600US13380,2021,92219,69074,23145
2634,310M600US13460,2021,83763,62174,21589
2635,310M600US13740,2021,77868,58664,19204
2636,310M600US13780,2021,105514,76991,28523
2637,310M600US13820,2021,436615,332176,104439
2638,310M600US13900,2021,52921,41275,11646
2639,310M600US13980,2021,66952,47258,19694
2640,310M600US14010,2021,69263,53024,16239
2641,310M600US14020,2021,65340,51970,13370
2642,310M600US14100,2021,33496,22915,10581
2644,310M600US14260,2021,294959,235734,59225
2645,310M600US14460,2021,1920160,1541950,378210
2646,310M600US14500,2021,135607,109955,25652
2647,310M600US14540,2021,71929,55405,16524
2650,310M600US14740,2021,106399,79197,27202
2651,310M600US14860,2021,357271,286932,70339
2652,310M600US15180,2021,135734,105545,30189
2653,310M600US15260,2021,46763,32156,14607
2654,310M600US15380,2021,503845,366980,136865
2655,310M600US15500,2021,69343,52181,17162
2656,310M600US15540,2021,93290,73946,19344
2657,310M600US15680,2021,42078,35194,6884
2658,310M600US15940,2021,168332,124835,43497
2659,310M600US15980,2021,320466,207107,113359
2660,310M600US16020,2021,37991,28937,9054
2661,310M600US16060,2021,55292,38182,17110
2662,310M600US16180,2021,23930,17083,6847
2663,310M600US16220,2021,33203,26273,6930
2664,310M600US16300,2021,112468,86500,25968
2666,310M600US16540,2021,62081,44008,18073
2667,310M600US16580,2021,91044,73373,17671
2668,310M600US16620,2021,106310,67264,39046
2669,310M600US16700,2021,316378,249439,66939
2670,310M600US16740,2021,1048452,853698,194754
2671,310M600US16820,2021,88339,67933,20406
2672,310M600US16860,2021,228853,172467,56386
2673,310M600US16940,2021,43728,32833,10895
2674,310M600US16980,2021,3670416,2910208,760208
2675,310M600US17020,2021,81353,60202,21151
2677,310M600US17140,2021,903245,699315,203930
2679,310M600US17300,2021,121468,95910,25558
2681,310M600US17420,2021,50236,36627,13609
2682,310M600US17460,2021,890105,658881,231224
2683,310M600US17660,2021,67771,49560,18211
2684,310M600US17780,2021,99917,81608,18309
2685,310M600US17820,2021,294814,244264,50550
2686,310M600US17860,2021,84946,68661,16285
2687,310M600US17900,2021,334313,257033,77280
2688,310M600US17980,2021,127247,94096,33151
2689,310M600US18020,2021,32518,27008,5510
2690,310M600US18140,2021,856193,696553,159640
2694,310M600US18580,2021,153119,120051,33068
2695,310M600US18700,2021,39350,29972,9378
2696,310M600US18880,2021,118438,91074,27364
2698,310M600US19060,2021,40079,26658,13421
2699,310M600US19100,2021,2836892,2420602,416290
2700,310M600US19140,2021,50580,38414,12166
2701,310M600US19180,2021,29007,19140,9867
2703,310M600US19300,2021,94105,65248,28857
2704,310M600US19340,2021,159133,115100,44033
2705,310M600US19430,2021,338505,252583,85922
2706,310M600US19460,2021,60796,43010,17786
2707,310M600US19500,2021,43914,29266,14648
2708,310M600US19660,2021,291531,189574,101957
2709,310M600US19740,2021,1192117,997620,194497
2710,310M600US19780,2021,291147,238260,52887
2711,310M600US19820,2021,1759573,1319341,440232
2712,310M600US20020,2021,61173,42222,18951
2713,310M600US20100,2021,70167,51361,18806
2715,310M600US20220,2021,40482,31866,8616
2716,310M600US20260,2021,124996,89640,35356
2717,310M600US20500,2021,263996,203243,60753
2718,310M600US20700,2021,65907,49555,16352
2719,310M600US20740,2021,70044,52469,17575
2720,310M600US20940,2021,47849,35409,12440
2721,310M600US21060,2021,58210,44036,14174
2722,310M600US21140,2021,69015,54317,14698
2723,310M600US21300,2021,35407,24212,11195
2724,310M600US21340,2021,299177,241993,57184
2725,310M600US21420,2021,23016,17285,5731
2726,310M600US21500,2021,110561,78998,31563
2727,310M600US21660,2021,160158,117954,42204
2729,310M600US21780,2021,132942,99982,32960
2730,310M600US21820,2021,36426,29907,6519
2731,310M600US22020,2021,109997,92853,17144
2734,310M600US22140,2021,40844,26878,13966
2735,310M600US22180,2021,198062,152172,45890
2736,310M600US22220,2021,206712,168812,37900
2738,310M600US22380,2021,55145,45022,10123
2739,310M600US22420,2021,167895,113949,53946
2740,310M600US22500,2021,77918,54124,23794
2741,310M600US22520,2021,61492,41909,19583
2742,310M600US22540,2021,42758,32483,10275
2743,310M600US22660,2021,152123,120312,31811
2745,310M600US22900,2021,97188,67143,30045
2746,310M600US23060,2021,168833,134026,34807
2748,310M600US23420,2021,322646,253275,69371
2749,310M600US23460,2021,38006,25189,12817
2750,310M600US23540,2021,134946,102834,32112
2751,310M600US23580,2021,72454,57026,15428
2753,310M600US23900,2021,39986,29929,10057
2754,310M600US24020,2021,54582,40570,14012
2756,310M600US24140,2021,46932,35466,11466
2757,310M600US24220,2021,43220,35449,7771
2758,310M600US24260,2021,30478,23760,6718
2759,310M600US24300,2021,63796,46381,17415
2760,310M600US24340,2021,410413,322947,87466
2761,310M600US24420,2021,36755,21877,14878
2762,310M600US24500,2021,34303,25208,9095
2763,310M600US24540,2021,119502,98789,20713
2764,310M600US24580,2021,135686,103503,32183
2766,310M600US24660,2021,307003,236955,70048
2767,310M600US24780,2021,75578,54753,20825
2768,310M600US24860,2021,373112,283536,89576
2770,310M600US25020,2021,25902,12622,13280
2771,310M600US25060,2021,162594,118344,44250
2772,310M600US25180,2021,117803,88575,29228
2773,310M600US25220,2021,49915,34996,14919
2774,310M600US25260,2021,43143,35294,7849
2775,310M600US25420,2021,243253,185819,57434
2776,310M600US25500,2021,50478,41157,9321
2777,310M600US25540,2021,488173,373435,114738
2778,310M600US25620,2021,66682,50411,16271
2782,310M600US25860,2021,146600,102689,43911
2784,310M600US25940,2021,89701,57994,31707
2785,310M600US25980,2021,29290,22727,6563
2788,310M600US26140,2021,68269,31930,36339
2789,310M600US26300,2021,42077,28024,14053
2790,310M600US26380,2021,82107,58618,23489
2791,310M600US26420,2021,2601401,2181761,419640
2792,310M600US26580,2021,144383,97175,47208
2793,310M600US26620,2021,205178,162820,42358
2795,310M600US26820,2021,54348,42166,12182
2797,310M600US26900,2021,834540,681871,152669
2798,310M600US26980,2021,69788,58062,11726
2799,310M600US27060,2021,44469,36298,8171
2800,310M600US27100,2021,61937,45701,16236
2801,310M600US27140,2021,228001,174788,53213
2802,310M600US27180,2021,71462,51641,19821
2803,310M600US27260,2021,644887,506699,138188
2804,310M600US27340,2021,73121,58292,14829
2806,310M600US27500,2021,67876,52229,15647
2808,310M600US27620,2021,55812,43022,12790
2809,310M600US27740,2021,86767,61933,24834
2810,310M600US27780,2021,55283,35696,19587
2811,310M600US27860,2021,51155,36820,14335
2812,310M600US27900,2021,69646,53424,16222
2813,310M600US27980,2021,56319,42917,13402
2814,310M600US28020,2021,105642,80907,24735
2816,310M600US28100,2021,41020,29474,11546
2817,310M600US28140,2021,883621,712587,171034
2820,310M600US28420,2021,105844,82445,23399
2822,310M600US28660,2021,174498,140399,34099
2823,310M600US28700,2021,128312,83544,44768
2824,310M600US28740,2021,75053,56750,18303
2826,310M600US28940,2021,361646,267144,94502
2827,310M600US29020,2021,36530,26163,10367
2828,310M600US29100,2021,58000,43014,14986
2829,310M600US29180,2021,187662,138504,49158
2830,310M600US29200,2021,88853,71394,17459
2832,310M600US29340,2021,72746,55178,17568
2834,310M600US29420,2021,102398,57327,45071
2835,310M600US29460,2021,276469,196722,79747
2836,310M600US29540,2021,210063,165666,44397
2837,310M600US29620,2021,220067,166001,54066
2838,310M600US29700,2021,78730,65920,12810
2839,310M600US29740,2021,85021,61622,23399
2840,310M600US29820,2021,854289,652696,201593
2842,310M600US29940,2021,49759,41089,8670
2843,310M600US30020,2021,46916,35065,11851
2845,310M600US30140,2021,54906,41195,13711
2846,310M600US30300,2021,27019,18576,8443
2847,310M600US30340,2021,46323,33933,12390
2848,310M600US30460,2021,215613,171416,44197
2849,310M600US30620,2021,41021,29097,11924
2850,310M600US30700,2021,138209,113322,24887
2851,310M600US30780,2021,308436,236511,71925
2852,310M600US30860,2021,48180,41989,6191
2854,310M600US30980,2021,106151,80136,26015
2855,310M600US31020,2021,43204,30456,12748
2856,310M600US31080,2021,4452780,3630330,822450
2857,310M600US31140,2021,522921,401965,120956
2858,310M600US31180,2021,129092,105127,23965
2861,310M600US31340,2021,103894,78394,25500
2862,310M600US31420,2021,85760,62225,23535
2863,310M600US31460,2021,44048,32086,11962
2864,310M600US31540,2021,292919,236657,56262
2865,310M600US31700,2021,167899,139880,28019
2866,310M600US31740,2021,51018,41450,9568
2868,310M600US31860,2021,40715,31906,8809
2869,310M600US31900,2021,49536,34679,14857
2874,310M600US32420,2021,36278,17599,18679
2875,310M600US32580,2021,268598,214137,54461
2877,310M600US32780,2021,90817,63410,27407
2878,310M600US32820,2021,520309,404598,115711
2879,310M600US32900,2021,84967,63738,21229
2881,310M600US33100,2021,2306639,1791028,515611
2882,310M600US33140,2021,43445,32570,10875
2883,310M600US33220,2021,35453,25387,10066
2884,310M600US33260,2021,68042,60592,7450
2885,310M600US33340,2021,649303,501920,147383
2886,310M600US33460,2021,1453400,1175448,277952
2888,310M600US33540,2021,51957,41189,10768
2889,310M600US33660,2021,168977,122853,46124
2890,310M600US33700,2021,174209,140886,33323
2891,310M600US33740,2021,80334,56852,23482
2892,310M600US33780,2021,61574,42777,18797
2893,310M600US33860,2021,150996,109653,41343
2895,310M600US34060,2021,56020,43508,12512
2896,310M600US34100,2021,53925,35540,18385
2899,310M600US34580,2021,51971,36341,15630
2900,310M600US34620,2021,45977,34452,11525
2901,310M600US34740,2021,67707,48222,19485
2903,310M600US34820,2021,210672,133173,77499
2904,310M600US34900,2021,49979,38736,11243
2905,310M600US34940,2021,163943,102638,61305
2906,310M600US34980,2021,794373,656660,137713
2907,310M600US35100,2021,51021,34637,16384
2909,310M600US35300,2021,349089,266900,82189
2910,310M600US35380,2021,507992,381929,126063
2912,310M600US35620,2021,7347700,5749891,1597809
2913,310M600US35660,2021,65764,47476,18288
2914,310M600US35840,2021,367538,227016,140522
2916,310M600US35980,2021,110950,83365,27585
2918,310M600US36100,2021,157348,98465,58883
2919,310M600US36140,2021,48860,35141,13719
2920,310M600US36220,2021,64169,54001,10168
2921,310M600US36260,2021,230356,191075,39281
2923,310M600US36420,2021,565309,444802,120507
2925,310M600US36500,2021,117186,88085,29101
2926,310M600US36540,2021,385487,311285,74202
2929,310M600US36740,2021,990500,785605,204895
2930,310M600US36780,2021,72794,56221,16573
2932,310M600US36980,2021,48574,34721,13853
2933,310M600US37100,2021,279168,220422,58746
2936,310M600US37340,2021,254314,176568,77746
2937,310M600US37460,2021,79532,63192,16340
2938,310M600US37620,2021,37656,25489,12167
2939,310M600US37860,2021,198702,150686,48016
2940,310M600US37900,2021,171067,125476,45591
2941,310M600US37980,2021,2442868,1901473,541395
2942,310M600US38060,2021,1863195,1467955,395240
2943,310M600US38220,2021,30092,20870,9222
2945,310M600US38300,2021,1025698,752015,273683
2946,310M600US38340,2021,57765,41508,16257
2948,310M600US38540,2021,36438,28115,8323
2949,310M600US38660,2021,75345,38400,36945
2951,310M600US38860,2021,237186,180960,56226
2952,310M600US38900,2021,1001984,797148,204836
2953,310M600US38940,2021,200954,135371,65583
2956,310M600US39100,2021,255736,200651,55085
2957,310M600US39150,2021,112075,68474,43601
2958,310M600US39300,2021,673701,514633,159068
2959,310M600US39340,2021,197599,177605,19994
2960,310M600US39380,2021,69078,47465,21613
2961,310M600US39460,2021,88988,48505,40483
2963,310M600US39540,2021,79068,60310,18758
2964,310M600US39580,2021,548713,453468,95245
2965,310M600US39660,2021,57532,45232,12300
2966,310M600US39740,2021,164312,126088,38224
2968,310M600US39820,2021,71506,48065,23441
2969,310M600US39900,2021,199715,155187,44528
2972,310M600US40060,2021,521067,408288,112779
2975,310M600US40140,2021,1441602,1138479,303123
2976,310M600US40220,2021,131211,93435,37776
2978,310M600US40340,2021,90956,73020,17936
2979,310M600US40380,2021,454044,336172,117872
2980,310M600US40420,2021,134008,98225,35783
2981,310M600US40580,2021,56840,40124,16716
2982,310M600US40660,2021,35417,26004,9413
2985,310M600US40900,2021,879647,681709,197938
2986,310M600US40980,2021,80146,52795,27351
2987,310M600US41060,2021,79091,64377,14714
2988,310M600US41100,2021,68090,44687,23403
2989,310M600US41140,2021,46798,34209,12589
2990,310M600US41180,2021,1144111,880615,263496
2992,310M600US41420,2021,158144,118890,39254
2993,310M600US41500,2021,133224,105725,27499
2994,310M600US41540,2021,177002,120526,56476
2995,310M600US41620,2021,443798,379639,64159
2996,310M600US41660,2021,46604,35809,10795
2997,310M600US41700,2021,948519,768619,179900
2998,310M600US41740,2021,1162896,937221,225675
3000,310M600US41860,2021,1719049,1384644,334405
3001,310M600US41900,2021,43263,19301,23962
3002,310M600US41940,2021,670900,564675,106225
3003,310M600US41980,2021,747507,433397,314110
3004,310M600US42020,2021,107571,79228,28343
3005,310M600US42100,2021,97353,75529,21824
3006,310M600US42140,2021,70152,49967,20185
3007,310M600US42200,2021,150550,117828,32722
3008,310M600US42220,2021,190586,145843,44743
3009,310M600US42340,2021,160666,126696,33970
3010,310M600US42540,2021,233473,168939,64534
3012,310M600US42660,2021,1584796,1310410,274386
3013,310M600US42680,2021,69974,40841,29133
3014,310M600US42700,2021,46166,25270,20896
3018,310M600US43100,2021,49416,37593,11823
3021,310M600US43300,2021,56005,42085,13920
3023,310M600US43340,2021,155848,110553,45295
3024,310M600US43420,2021,49952,30933,19019
3025,310M600US43580,2021,57421,45992,11429
3026,310M600US43620,2021,114967,98385,16582
3029,310M600US43780,2021,128774,95757,33017
3030,310M600US43900,2021,128437,99653,28784
3031,310M600US44060,2021,237024,177408,59616
3032,310M600US44100,2021,89340,63629,25711
3033,310M600US44140,2021,275788,195829,79959
3034,310M600US44180,2021,195260,149479,45781
3035,310M600US44220,2021,57013,40885,16128
3036,310M600US44300,2021,57518,43178,14340
3038,310M600US44420,2021,51802,38134,13668
3041,310M600US44700,2021,241760,194217,47543
3042,310M600US44940,2021,54669,37088,17581
3044,310M600US45060,2021,270350,200037,70313
3046,310M600US45220,2021,155921,124431,31490
3047,310M600US45300,2021,1309614,957360,352254
3048,310M600US45460,2021,73024,51821,21203
3049,310M600US45500,2021,55179,38362,16817
3050,310M600US45540,2021,68792,23521,45271
3051,310M600US45780,2021,273165,204607,68558
3052,310M600US45820,2021,95988,68983,27005
3055,310M600US45940,2021,143970,109944,34026
3057,310M600US46060,2021,433148,318275,114873
3059,310M600US46140,2021,403034,309482,93552
3061,310M600US46220,2021,101825,76353,25472
3062,310M600US46300,2021,42906,33097,9809
3063,310M600US46340,2021,81175,63626,17549
3065,310M600US46520,2021,338093,271245,66848
3066,310M600US46540,2021,118513,82942,35571
3067,310M600US46660,2021,55279,38512,16767
3068,310M600US46700,2021,157617,122954,34663
3069,310M600US47020,2021,41036,31831,9205
3070,310M600US47220,2021,53883,40366,13517
3071,310M600US47260,2021,721212,578555,142657
3072,310M600US47300,2021,143541,114690,28851
3073,310M600US47380,2021,102138,83280,18858
3074,310M600US47460,2021,23444,17007,6437
3075,310M600US47580,2021,70357,56033,14324
3077,310M600US47900,2021,2384977,2002477,382500
3078,310M600US47940,2021,68479,51750,16729
3080,310M600US48060,2021,48628,37394,11234
3081,310M600US48140,2021,69891,53727,16164
3082,310M600US48260,2021,49145,32769,16376
3083,310M600US48300,2021,47559,35021,12538
3084,310M600US48540,2021,57332,39277,18055
3086,310M600US48620,2021,250146,194781,55365
3087,310M600US48660,2021,56846,42179,14667
3088,310M600US48700,2021,47022,35141,11881
3089,310M600US48900,2021,127095,98711,28384
3091,310M600US49020,2021,52949,40011,12938
3092,310M600US49180,2021,273913,202628,71285
3095,310M600US49340,2021,379159,296750,82409
3096,310M600US49420,2021,86992,67310,19682
3097,310M600US49500,2021,29142,14044,15098
3098,310M600US49620,2021,178898,137545,41353
3099,310M600US49660,2021,230536,154598,75938
3100,310M600US49700,2021,61597,48534,13063
3101,310M600US49740,2021,74981,55020,19961
3104,310M600US10180,2022,65753,52696,13057
3106,310M600US10380,2022,115856,61004,54852
3107,310M600US10420,2022,294908,220780,74128
3109,310M600US10500,2022,57664,40417,17247
3110,310M600US10540,2022,51267,38801,12466
3111,310M600US10580,2022,379968,284424,95544
3113,310M600US10740,2022,379471,289332,90139
3114,310M600US10780,2022,55261,40805,14456
3115,310M600US10900,2022,338114,258669,79445
3116,310M600US11020,2022,52260,35926,16334
3117,310M600US11100,2022,100975,79038,21937
3118,310M600US11180,2022,50987,42181,8806
3119,310M600US11260,2022,149798,123820,25978
3120,310M600US11460,2022,150945,121545,29400
3121,310M600US11500,2022,45701,31462,14239
3122,310M600US11540,2022,100640,79596,21044
3123,310M600US11640,2022,66631,38226,28405
3124,310M600US11700,2022,190656,133975,56681
3127,310M600US12020,2022,85600,67458,18142
3128,310M600US12060,2022,2311639,1928511,383128
3129,310M600US12100,2022,106972,81248,25724
3131,310M600US12220,2022,71830,55610,16220
3132,310M600US12260,2022,232374,171463,60911
3134,310M600US12420,2022,1000103,867586,132517
3135,310M600US12540,2022,283510,223788,59722
3136,310M600US12580,2022,1126216,892323,233893
3137,310M600US12620,2022,65940,45557,20383
3139,310M600US12700,2022,107187,73216,33971
3140,310M600US12940,2022,337685,258946,78739
3141,310M600US12980,2022,53388,40043,13345
3142,310M600US13020,2022,44664,29854,14810
3143,310M600US13140,2022,152263,117023,35240
3145,310M600US13220,2022,44109,26173,17936
3146,310M600US13380,2022,94813,71402,23411
3147,310M600US13460,2022,85108,63767,21341
3148,310M600US13740,2022,79190,63693,15497
3149,310M600US13780,2022,102017,76138,25879
3150,310M600US13820,2022,443821,340730,103091
3151,310M600US13900,2022,56463,43580,12883
3152,310M600US13980,2022,62348,47759,14589
3153,310M600US14010,2022,68879,53910,14969
3154,310M600US14020,2022,68801,55230,13571
3155,310M600US14100,2022,34895,24839,10056
3157,310M600US14260,2022,302858,240544,62314
3158,310M600US14460,2022,1948354,1568654,379700
3159,310M600US14500,2022,137786,112375,25411
3160,310M600US14540,2022,72037,53234,18803
3163,310M600US14740,2022,109245,82822,26423
3164,310M600US14860,2022,357412,287764,69648
3165,310M600US15180,2022,137982,105253,32729
3166,310M600US15260,2022,47874,32836,15038
3167,310M600US15380,2022,505423,373744,131679
3168,310M600US15500,2022,70125,53732,16393
3169,310M600US15540,2022,97271,78183,19088
3170,310M600US15680,2022,44392,35181,9211
3171,310M600US15940,2022,166456,122526,43930
3172,310M600US15980,2022,339269,218547,120722
3173,310M600US16020,2022,38568,29466,9102
3174,310M600US16060,2022,56716,41562,15154
3175,310M600US16180,2022,23205,15609,7596
3176,310M600US16220,2022,33474,26240,7234
3177,310M600US16300,2022,113649,88061,25588
3179,310M600US16540,2022,64960,48560,16400
3180,310M600US16580,2022,91682,69991,21691
3181,310M600US16620,2022,107179,69972,37207
3182,310M600US16700,2022,338067,272128,65939
3183,310M600US16740,2022,1085889,886183,199706
3184,310M600US16820,2022,90108,67657,22451
3185,310M600US16860,2022,231091,174805,56286
3186,310M600US16940,2022,42559,32835,9724
3187,310M600US16980,2022,3726266,2970903,755363
3188,310M600US17020,2022,82494,60506,21988
3190,310M600US17140,2022,916246,720581,195665
3192,310M600US17300,2022,127103,105355,21748
3194,310M600US17420,2022,49379,38056,11323
3195,310M600US17460,2022,891430,662871,228559
3196,310M600US17660,2022,71309,51632,19677
3197,310M600US17780,2022,109360,89708,19652
3198,310M600US17820,2022,306162,252358,53804
3199,310M600US17860,2022,87953,68075,19878
3200,310M600US17900,2022,339602,268448,71154
3201,310M600US17980,2022,125934,91972,33962
3202,310M600US18020,2022,34436,25930,8506
3203,310M600US18140,2022,864711,702983,161728
3207,310M600US18580,2022,156365,122158,34207
3208,310M600US18700,2022,38831,29105,9726
3209,310M600US18880,2022,123619,99327,24292
3211,310M600US19060,2022,36953,23360,13593
3212,310M600US19100,2022,2908436,2490183,418253
3213,310M600US19140,2022,51845,40336,11509
3214,310M600US19180,2022,30967,20808,10159
3216,310M600US19300,2022,98854,71517,27337
3217,310M600US19340,2022,163066,119977,43089
3218,310M600US19430,2022,348034,262246,85788
3219,310M600US19460,2022,62616,44607,18009
3220,310M600US19500,2022,43718,29440,14278
3221,310M600US19660,2022,296235,199018,97217
3222,310M600US19740,2022,1223825,1028090,195735
3223,310M600US19780,2022,297060,241964,55096
3224,310M600US19820,2022,1762104,1323463,438641
3225,310M600US20020,2022,60106,43238,16868
3226,310M600US20100,2022,73497,54752,18745
3229,310M600US20220,2022,40644,31235,9409
3230,310M600US20260,2022,126137,90307,35830
3231,310M600US20500,2022,273170,220654,52516
3232,310M600US20700,2022,58034,42969,15065
3233,310M600US20740,2022,72293,57102,15191
3234,310M600US20940,2022,50877,39244,11633
3235,310M600US21060,2022,62918,47206,15712
3236,310M600US21140,2022,74362,58175,16187
3237,310M600US21300,2022,34319,23826,10493
3238,310M600US21340,2022,301489,242230,59259
3239,310M600US21420,2022,23054,17801,5253
3240,310M600US21500,2022,111286,81113,30173
3241,310M600US21660,2022,160316,118282,42034
3243,310M600US21780,2022,132135,98160,33975
3244,310M600US21820,2022,37356,31072,6284
3245,310M600US22020,2022,110171,92613,17558
3248,310M600US22140,2022,41542,28873,12669
3249,310M600US22180,2022,202349,158141,44208
3250,310M600US22220,2022,216921,178590,38331
3252,310M600US22380,2022,53988,42088,11900
3253,310M600US22420,2022,167950,120218,47732
3254,310M600US22500,2022,79506,57633,21873
3255,310M600US22520,2022,64312,46200,18112
3256,310M600US22540,2022,43958,32333,11625
3257,310M600US22660,2022,154391,123447,30944
3259,310M600US22900,2022,99401,71098,28303
3260,310M600US23060,2022,169643,135685,33958
3262,310M600US23420,2022,326981,264748,62233
3263,310M600US23460,2022,39956,27576,12380
3264,310M600US23540,2022,143046,105567,37479
3265,310M600US23580,2022,74331,58043,16288
3267,310M600US23900,2022,40676,28954,11722
3268,310M600US24020,2022,54954,38868,16086
3270,310M600US24140,2022,47283,36092,11191
3272,310M600US24220,2022,42754,34804,7950
3273,310M600US24260,2022,30423,24021,6402
3274,310M600US24300,2022,66134,50811,15323
3275,310M600US24340,2022,415694,329960,85734
3276,310M600US24420,2022,36633,23355,13278
3277,310M600US24500,2022,35343,25925,9418
3278,310M600US24540,2022,123825,101056,22769
3279,310M600US24580,2022,136782,104377,32405
3281,310M600US24660,2022,318752,242998,75754
3282,310M600US24780,2022,74938,58493,16445
3283,310M600US24860,2022,387161,297835,89326
3285,310M600US25020,2022,28791,15459,13332
3286,310M600US25060,2022,170440,123065,47375
3287,310M600US25180,2022,118011,89257,28754
3288,310M600US25220,2022,51689,37846,13843
3289,310M600US25260,2022,43646,36050,7596
3290,310M600US25420,2022,247424,185185,62239
3291,310M600US25500,2022,50885,40687,10198
3292,310M600US25540,2022,494046,381179,112867
3293,310M600US25620,2022,66557,48969,17588
3297,310M600US25860,2022,151501,113458,38043
3299,310M600US25940,2022,93078,62965,30113
3300,310M600US25980,2022,29850,24854,4996
3303,310M600US26140,2022,71493,38297,33196
3304,310M600US26300,2022,45340,29336,16004
3305,310M600US26380,2022,78534,56988,21546
3306,310M600US26420,2022,2682645,2271310,411335
3307,310M600US26580,2022,147441,99750,47691
3308,310M600US26620,2022,206490,164947,41543
3310,310M600US26820,2022,54935,44178,10757
3312,310M600US26900,2022,852384,692280,160104
3313,310M600US26980,2022,72536,60345,12191
3314,310M600US27060,2022,42108,31218,10890
3315,310M600US27100,2022,63368,44987,18381
3316,310M600US27140,2022,224102,170886,53216
3317,310M600US27180,2022,70592,53964,16628
3318,310M600US27260,2022,672026,530825,141201
3319,310M600US27340,2022,75898,61653,14245
3321,310M600US27500,2022,67422,51678,15744
3323,310M600US27620,2022,57464,43543,13921
3324,310M600US27740,2022,88924,65361,23563
3325,310M600US27780,2022,55225,35841,19384
3326,310M600US27860,2022,53427,40013,13414
3327,310M600US27900,2022,70960,54187,16773
3328,310M600US27980,2022,57355,45441,11914
3329,310M600US28020,2022,108397,85392,23005
3331,310M600US28100,2022,40585,29004,11581
3332,310M600US28140,2022,897185,712693,184492
3335,310M600US28420,2022,108521,87816,20705
3337,310M600US28660,2022,179677,145250,34427
3338,310M600US28700,2022,132965,88913,44052
3339,310M600US28740,2022,75187,56649,18538
3341,310M600US28940,2022,369673,275464,94209
3342,310M600US29020,2022,35752,23903,11849
3343,310M600US29100,2022,59350,45541,13809
3344,310M600US29180,2022,194293,143850,50443
3345,310M600US29200,2022,91610,71920,19690
3347,310M600US29340,2022,79885,58967,20918
3349,310M600US29420,2022,99512,56978,42534
3350,310M600US29460,2022,291994,207225,84769
3351,310M600US29540,2022,212016,166064,45952
3352,310M600US29620,2022,223066,169239,53827
3353,310M600US29700,2022,82519,69543,12976
3354,310M600US29740,2022,85746,63726,22020
3355,310M600US29820,2022,857362,672455,184907
3357,310M600US29940,2022,50248,41888,8360
3358,310M600US30020,2022,47959,37759,10200
3360,310M600US30140,2022,55245,40436,14809
3361,310M600US30300,2022,28080,19429,8651
3362,310M600US30340,2022,46233,36144,10089
3363,310M600US30460,2022,216988,176745,40243
3364,310M600US30620,2022,41028,30641,10387
3365,310M600US30700,2022,138815,112250,26565
3366,310M600US30780,2022,313550,232629,80921
3367,310M600US30860,2022,50421,43860,6561
3369,310M600US30980,2022,109049,81672,27377
3370,310M600US31020,2022,44049,30893,13156
3371,310M600US31080,2022,4500951,3706276,794675
3372,310M600US31140,2022,535884,413994,121890
3373,310M600US31180,2022,132085,107913,24172
3376,310M600US31340,2022,102617,73704,28913
3377,310M600US31420,2022,91458,64099,27359
3378,310M600US31460,2022,45539,34821,10718
3379,310M600US31540,2022,303340,246596,56744
3380,310M600US31700,2022,167816,137761,30055
3381,310M600US31740,2022,51590,43672,7918
3383,310M600US31860,2022,41242,31801,9441
3384,310M600US31900,2022,50248,35183,15065
3389,310M600US32420,2022,38332,18443,19889
3390,310M600US32580,2022,270891,219395,51496
3392,310M600US32780,2022,92554,66631,25923
3393,310M600US32820,2022,518924,411990,106934
3394,310M600US32900,2022,87830,68880,18950
3396,310M600US33100,2022,2344046,1835884,508162
3397,310M600US33140,2022,43213,31865,11348
3398,310M600US33220,2022,35325,25731,9594
3399,310M600US33260,2022,71062,61926,9136
3400,310M600US33340,2022,654547,499719,154828
3401,310M600US33460,2022,1483453,1197793,285660
3403,310M600US33540,2022,53358,42678,10680
3404,310M600US33660,2022,168967,122484,46483
3405,310M600US33700,2022,177101,141950,35151
3406,310M600US33740,2022,82655,60674,21981
3407,310M600US33780,2022,62946,45010,17936
3408,310M600US33860,2022,152492,112348,40144
3410,310M600US34060,2022,57354,44736,12618
3411,310M600US34100,2022,59553,43480,16073
3414,310M600US34580,2022,50818,35548,15270
3415,310M600US34620,2022,47478,36115,11363
3416,310M600US34740,2022,67255,47837,19418
3418,310M600US34820,2022,231614,152912,78702
3419,310M600US34900,2022,51025,37997,13028
3420,310M600US34940,2022,166206,104002,62204
3421,310M600US34980,2022,831347,694094,137253
3422,310M600US35100,2022,51749,36040,15709
3424,310M600US35300,2022,345632,265184,80448
3425,310M600US35380,2022,499885,377909,121976
3427,310M600US35620,2022,7478571,5903723,1574848
3428,310M600US35660,2022,63311,45861,17450
3429,310M600US35840,2022,391897,243166,148731
3431,310M600US35980,2022,112629,84370,28259
3433,310M600US36100,2022,163513,100172,63341
3434,310M600US36140,2022,48563,34716,13847
3435,310M600US36220,2022,63738,53935,9803
3436,310M600US36260,2022,235531,199199,36332
3438,310M600US36420,2022,569766,456149,113617
3440,310M600US36500,2022,118571,89727,28844
3441,310M600US36540,2022,392615,320895,71720
3444,310M600US36740,2022,1054342,847647,206695
3445,310M600US36780,2022,72135,55154,16981
3447,310M600US36980,2022,47897,32869,15028
3448,310M600US37100,2022,278631,221598,57033
3451,310M600US37340,2022,255723,181385,74338
3452,310M600US37460,2022,79044,61739,17305
3453,310M600US37620,2022,39716,27684,12032
3454,310M600US37860,2022,207329,156557,50772
3455,310M600US37900,2022,169299,125844,43455
3456,310M600US37980,2022,2483863,1948761,535102
3457,310M600US38060,2022,1890835,1490257,400578
3458,310M600US38220,2022,30449,20428,10021
3460,310M600US38300,2022,1021314,747412,273902
3461,310M600US38340,2022,58370,41675,16695
3463,310M600US38540,2022,37564,28266,9298
3464,310M600US38660,2022,83805,43234,40571
3466,310M600US38860,2022,242440,184610,57830
3467,310M600US38900,2022,1011708,808159,203549
3468,310M600US38940,2022,201086,131061,70025
3471,310M600US39100,2022,256785,201650,55135
3472,310M600US39150,2022,110928,66308,44620
3473,310M600US39300,2022,679882,515645,164237
3474,310M600US39340,2022,208607,186659,21948
3475,310M600US39380,2022,67840,47681,20159
3476,310M600US39460,2022,90457,48924,41533
3478,310M600US39540,2022,78571,58730,19841
3479,310M600US39580,2022,559173,463488,95685
3480,310M600US39660,2022,59768,45369,14399
3481,310M600US39740,2022,162183,124544,37639
3483,310M600US39820,2022,71213,48843,22370
3484,310M600US39900,2022,200436,155889,44547
3487,310M600US40060,2022,538478,425519,112959
3490,310M600US40140,2022,1443666,1161444,282222
3491,310M600US40220,2022,133108,94665,38443
3493,310M600US40340,2022,95252,75182,20070
3494,310M600US40380,2022,456391,339984,116407
3495,310M600US40420,2022,134011,98268,35743
3496,310M600US40580,2022,58696,43337,15359
3497,310M600US40660,2022,38087,28418,9669
3500,310M600US40900,2022,884646,687158,197488
3501,310M600US40980,2022,79275,55704,23571
3502,310M600US41060,2022,78630,61416,17214
3503,310M600US41100,2022,71891,52118,19773
3504,310M600US41140,2022,47125,35363,11762
3505,310M600US41180,2022,1168546,904944,263602
3507,310M600US41420,2022,161384,121514,39870
3508,310M600US41500,2022,132411,106470,25941
3509,310M600US41540,2022,179028,124937,54091
3510,310M600US41620,2022,448172,388243,59929
3511,310M600US41660,2022,48115,37349,10766
3512,310M600US41700,2022,972848,794571,178277
3513,310M600US41740,2022,1172343,960413,211930
3516,310M600US41860,2022,1739127,1411119,328008
3517,310M600US41900,2022,47510,26687,20823
3518,310M600US41940,2022,677087,575206,101881
3519,310M600US41980,2022,833941,501022,332919
3520,310M600US42020,2022,111713,82438,29275
3521,310M600US42100,2022,96015,74879,21136
3522,310M600US42140,2022,72302,50395,21907
3523,310M600US42200,2022,150851,118712,32139
3524,310M600US42220,2022,194698,149397,45301
3525,310M600US42340,2022,163204,131163,32041
3526,310M600US42540,2022,235346,172693,62653
3528,310M600US42660,2022,1611580,1337056,274524
3529,310M600US42680,2022,72199,43510,28689
3530,310M600US42700,2022,47706,24007,23699
3534,310M600US43100,2022,50534,37967,12567
3537,310M600US43300,2022,54309,41582,12727
3539,310M600US43340,2022,157155,115911,41244
3540,310M600US43420,2022,49981,31936,18045
3541,310M600US43580,2022,58633,45657,12976
3542,310M600US43620,2022,119013,102084,16929
3545,310M600US43780,2022,127381,97015,30366
3546,310M600US43900,2022,133018,101663,31355
3547,310M600US44060,2022,240227,177307,62920
3548,310M600US44100,2022,86964,59382,27582
3549,310M600US44140,2022,277761,200364,77397
3550,310M600US44180,2022,199835,149475,50360
3551,310M600US44220,2022,56033,38387,17646
3552,310M600US44300,2022,60457,47333,13124
3554,310M600US44420,2022,50966,36930,14036
3557,310M600US44700,2022,241903,197308,44595
3558,310M600US44940,2022,53824,38932,14892
3560,310M600US45060,2022,275997,207722,68275
3562,310M600US45220,2022,156383,120518,35865
3563,310M600US45300,2022,1329075,978479,350596
3564,310M600US45460,2022,73268,52645,20623
3565,310M600US45500,2022,55624,36913,18711
3566,310M600US45540,2022,71378,25312,46066
3567,310M600US45780,2022,277534,208112,69422
3568,310M600US45820,2022,98367,71704,26663
3571,310M600US45940,2022,144989,110897,34092
3573,310M600US46060,2022,436469,315509,120960
3575,310M600US46140,2022,408399,317019,91380
3577,310M600US46220,2022,106516,79414,27102
3578,310M600US46300,2022,43679,34948,8731
3579,310M600US46340,2022,80889,62269,18620
3581,310M600US46520,2022,338438,269044,69394
3582,310M600US46540,2022,123639,87829,35810
3583,310M600US46660,2022,57838,43782,14056
3584,310M600US46700,2022,159294,122389,36905
3585,310M600US47020,2022,37469,29020,8449
3586,310M600US47220,2022,54961,42230,12731
3587,310M600US47260,2022,716273,570468,145805
3588,310M600US47300,2022,143129,117800,25329
3589,310M600US47380,2022,100777,81691,19086
3590,310M600US47460,2022,23389,16288,7101
3591,310M600US47580,2022,74524,57651,16873
3593,310M600US47900,2022,2422671,2052991,369680
3594,310M600US47940,2022,69878,52580,17298
3596,310M600US48060,2022,46815,35377,11438
3597,310M600US48140,2022,69387,50876,18511
3598,310M600US48260,2022,49583,33967,15616
3599,310M600US48300,2022,48514,36316,12198
3600,310M600US48540,2022,56516,38198,18318
3602,310M600US48620,2022,252826,199211,53615
3603,310M600US48660,2022,57968,45243,12725
3604,310M600US48700,2022,46774,34655,12119
3605,310M600US48900,2022,130017,100305,29712
3607,310M600US49020,2022,55012,43089,11923
3608,310M600US49180,2022,278269,202445,75824
3611,310M600US49340,2022,385088,301732,83356
3612,310M600US49420,2022,87616,68337,19279
3613,310M600US49500,2022,32081,18377,13704
3614,310M600US49620,2022,184019,142961,41058
3615,310M600US49660,2022,229685,160845,68840
3616,310M600US49700,2022,63162,47172,15990
3617,310M600US49740,2022,80857,56540,24317
3620,310M600US10180,2022,65753,52696,13057
3622,310M600US10380,2022,115856,61004,54852
3623,310M600US10420,2022,294908,220780,74128
3625,310M600US10500,2022,57664,40417,17247
3626,310M600US10540,2022,51267,38801,12466
3627,310M600US10580,2022,379968,284424,95544
3629,310M600US10740,2022,379471,289332,90139
3630,310M600US10780,2022,55261,40805,14456
3631,310M600US10900,2022,338114,258669,79445
3632,310M600US11020,2022,52260,35926,16334
3633,310M600US11100,2022,100975,79038,21937
3634,310M600US11180,2022,50987,42181,8806
3635,310M600US11260,2022,149798,123820,25978
3636,310M600US11460,2022,150945,121545,29400
3637,310M600US11500,2022,45701,31462,14239
3638,310M600US11540,2022,100640,79596,21044
3639,310M600US11640,2022,66631,38226,28405
3640,310M600US11700,2022,190656,133975,56681
3643,310M600US12020,2022,85600,67458,18142
3644,310M600US12060,2022,2311639,1928511,383128
3645,310M600US12100,2022,106972,81248,25724
3647,310M600US12220,2022,71830,55610,16220
3648,310M600US12260,2022,232374,171463,60911
3650,310M600US12420,2022,1000103,867586,132517
3651,310M600US12540,2022,283510,223788,59722
3652,310M600US12580,2022,1126216,892323,233893
3653,310M600US12620,2022,65940,45557,20383
3655,310M600US12700,2022,107187,73216,33971
3656,310M600US12940,2022,337685,258946,78739
3657,310M600US12980,2022,53388,40043,13345
3658,310M600US13020,2022,44664,29854,14810
3659,310M600US13140,2022,152263,117023,35240
3661,310M600US13220,2022,44109,26173,17936
3662,310M600US13380,2022,94813,71402,23411
3663,310M600US13460,2022,85108,63767,21341
3664,310M600US13740,2022,79190,63693,15497
3665,310M600US13780,2022,102017,76138,25879
3666,310M600US13820,2022,443821,340730,103091
3667,310M600US13900,2022,56463,43580,12883
3668,310M600US13980,2022,62348,47759,14589
3669,310M600US14010,2022,68879,53910,14969
3670,310M600US14020,2022,68801,55230,13571
3671,310M600US14100,2022,34895,24839,10056
3673,310M600US14260,2022,302858,240544,62314
3674,310M600US14460,2022,1948354,1568654,379700
3675,310M600US14500,2022,137786,112375,25411
3676,310M600US14540,2022,72037,53234,18803
3679,310M600US14740,2022,109245,82822,26423
3680,310M600US14860,2022,357412,287764,69648
3681,310M600US15180,2022,137982,105253,32729
3682,310M600US15260,2022,47874,32836,15038
3683,310M600US15380,2022,505423,373744,131679
3684,310M600US15500,2022,70125,53732,16393
3685,310M600US15540,2022,97271,78183,19088
3686,310M600US15680,2022,44392,35181,9211
3687,310M600US15940,2022,166456,122526,43930
3688,310M600US15980,2022,339269,218547,120722
3689,310M600US16020,2022,38568,29466,9102
3690,310M600US16060,2022,56716,41562,15154
3691,310M600US16180,2022,23205,15609,7596
3692,310M600US16220,2022,33474,26240,7234
3693,310M600US16300,2022,113649,88061,25588
3695,310M600US16540,2022,64960,48560,16400
3696,310M600US16580,2022,91682,69991,21691
3697,310M600US16620,2022,107179,69972,37207
3698,310M600US16700,2022,338067,272128,65939
3699,310M600US16740,2022,1085889,886183,199706
3700,310M600US16820,2022,90108,67657,22451
3701,310M600US16860,2022,231091,174805,56286
3702,310M600US16940,2022,42559,32835,9724
3703,310M600US16980,2022,3726266,2970903,755363
3704,310M600US17020,2022,82494,60506,21988
3706,310M600US17140,2022,916246,720581,195665
3708,310M600US17300,2022,127103,105355,21748
3710,310M600US17420,2022,49379,38056,11323
3711,310M600US17460,2022,891430,662871,228559
3712,310M600US17660,2022,71309,51632,19677
3713,310M600US17780,2022,109360,89708,19652
3714,310M600US17820,2022,306162,252358,53804
3715,310M600US17860,2022,87953,68075,19878
3716,310M600US17900,2022,339602,268448,71154
3717,310M600US17980,2022,125934,91972,33962
3718,310M600US18020,2022,34436,25930,8506
3719,310M600US18140,2022,864711,702983,161728
3723,310M600US18580,2022,156365,122158,34207
3724,310M600US18700,2022,38831,29105,9726
3725,310M600US18880,2022,123619,99327,24292
3727,310M600US19060,2022,36953,23360,13593
3728,310M600US19100,2022,2908436,2490183,418253
3729,310M600US19140,2022,51845,40336,11509
3730,310M600US19180,2022,30967,20808,10159
3732,310M600US19300,2022,98854,71517,27337
3733,310M600US19340,2022,163066,119977,43089
3734,310M600US19430,2022,348034,262246,85788
3735,310M600US19460,2022,62616,44607,18009
3736,310M600US19500,2022,43718,29440,14278
3737,310M600US19660,2022,296235,199018,97217
3738,310M600US19740,2022,1223825,1028090,195735
3739,310M600US19780,2022,297060,241964,55096
3740,310M600US19820,2022,1762104,1323463,438641
3741,310M600US20020,2022,60106,43238,16868
3742,310M600US20100,2022,73497,54752,18745
3745,310M600US20220,2022,40644,31235,9409
3746,310M600US20260,2022,126137,90307,35830
3747,310M600US20500,2022,273170,220654,52516
3748,310M600US20700,2022,58034,42969,15065
3749,310M600US20740,2022,72293,57102,15191
3750,310M600US20940,2022,50877,39244,11633
3751,310M600US21060,2022,62918,47206,15712
3752,310M600US21140,2022,74362,58175,16187
3753,310M600US21300,2022,34319,23826,10493
3754,310M600US21340,2022,301489,242230,59259
3755,310M600US21420,2022,23054,17801,5253
3756,310M600US21500,2022,111286,81113,30173
3757,310M600US21660,2022,160316,118282,42034
3759,310M600US21780,2022,132135,98160,33975
3760,310M600US21820,2022,37356,31072,6284
3761,310M600US22020,2022,110171,92613,17558
3764,310M600US22140,2022,41542,28873,12669
3765,310M600US22180,2022,202349,158141,44208
3766,310M600US22220,2022,216921,178590,38331
3768,310M600US22380,2022,53988,42088,11900
3769,310M600US22420,2022,167950,120218,47732
3770,310M600US22500,2022,79506,57633,21873
3771,310M600US22520,2022,64312,46200,18112
3772,310M600US22540,2022,43958,32333,11625
3773,310M600US22660,2022,154391,123447,30944
3775,310M600US22900,2022,99401,71098,28303
3776,310M600US23060,2022,169643,135685,33958
3778,310M600US23420,2022,326981,264748,62233
3779,310M600US23460,2022,39956,27576,12380
3780,310M600US23540,2022,143046,105567,37479
3781,310M600US23580,2022,74331,58043,16288
3783,310M600US23900,2022,40676,28954,11722
3784,310M600US24020,2022,54954,38868,16086
3786,310M600US24140,2022,47283,36092,11191
3788,310M600US24220,2022,42754,34804,7950
3789,310M600US24260,2022,30423,24021,6402
3790,310M600US24300,2022,66134,50811,15323
3791,310M600US24340,2022,415694,329960,85734
3792,310M600US24420,2022,36633,23355,13278
3793,310M600US24500,2022,35343,25925,9418
3794,310M600US24540,2022,123825,101056,22769
3795,310M600US24580,2022,136782,104377,32405
3797,310M600US24660,2022,318752,242998,75754
3798,310M600US24780,2022,74938,58493,16445
3799,310M600US24860,2022,387161,297835,89326
3801,310M600US25020,2022,28791,15459,13332
3802,310M600US25060,2022,170440,123065,47375
3803,310M600US25180,2022,118011,89257,28754
3804,310M600US25220,2022,51689,37846,13843
3805,310M600US25260,2022,43646,36050,7596
3806,310M600US25420,2022,247424,185185,62239
3807,310M600US25500,2022,50885,40687,10198
3808,310M600US25540,2022,494046,381179,112867
3809,310M600US25620,2022,66557,48969,17588
3813,310M600US25860,2022,151501,113458,38043
3815,310M600US25940,2022,93078,62965,30113
3816,310M600US25980,2022,29850,24854,4996
3819,310M600US26140,2022,71493,38297,33196
3820,310M600US26300,2022,45340,29336,16004
3821,310M600US26380,2022,78534,56988,21546
3822,310M600US26420,2022,2682645,2271310,411335
3823,310M600US26580,2022,147441,99750,47691
3824,310M600US26620,2022,206490,164947,41543
3826,310M600US26820,2022,54935,44178,10757
3828,310M600US26900,2022,852384,692280,160104
3829,310M600US26980,2022,72536,60345,12191
3830,310M600US27060,2022,42108,31218,10890
3831,310M600US27100,2022,63368,44987,18381
3832,310M600US27140,2022,224102,170886,53216
3833,310M600US27180,2022,70592,53964,16628
3834,310M600US27260,2022,672026,530825,141201
3835,310M600US27340,2022,75898,61653,14245
3837,310M600US27500,2022,67422,51678,15744
3839,310M600US27620,2022,57464,43543,13921
3840,310M600US27740,2022,88924,65361,23563
3841,310M600US27780,2022,55225,35841,19384
3842,310M600US27860,2022,53427,40013,13414
3843,310M600US27900,2022,70960,54187,16773
3844,310M600US27980,2022,57355,45441,11914
3845,310M600US28020,2022,108397,85392,23005
3847,310M600US28100,2022,40585,29004,11581
3848,310M600US28140,2022,897185,712693,184492
3851,310M600US28420,2022,108521,87816,20705
3853,310M600US28660,2022,179677,145250,34427
3854,310M600US28700,2022,132965,88913,44052
3855,310M600US28740,2022,75187,56649,18538
3857,310M600US28940,2022,369673,275464,94209
3858,310M600US29020,2022,35752,23903,11849
3859,310M600US29100,2022,59350,45541,13809
3860,310M600US29180,2022,194293,143850,50443
3861,310M600US29200,2022,91610,71920,19690
3863,310M600US29340,2022,79885,58967,20918
3865,310M600US29420,2022,99512,56978,42534
3866,310M600US29460,2022,291994,207225,84769
3867,310M600US29540,2022,212016,166064,45952
3868,310M600US29620,2022,223066,169239,53827
3869,310M600US29700,2022,82519,69543,12976
3870,310M600US29740,2022,85746,63726,22020
3871,310M600US29820,2022,857362,672455,184907
3873,310M600US29940,2022,50248,41888,8360
3874,310M600US30020,2022,47959,37759,10200
3876,310M600US30140,2022,55245,40436,14809
3877,310M600US30300,2022,28080,19429,8651
3878,310M600US30340,2022,46233,36144,10089
3879,310M600US30460,2022,216988,176745,40243
3880,310M600US30620,2022,41028,30641,10387
3881,310M600US30700,2022,138815,112250,26565
3882,310M600US30780,2022,313550,232629,80921
3883,310M600US30860,2022,50421,43860,6561
3885,310M600US30980,2022,109049,81672,27377
3886,310M600US31020,2022,44049,30893,13156
3887,310M600US31080,2022,4500951,3706276,794675
3888,310M600US31140,2022,535884,413994,121890
3889,310M600US31180,2022,132085,107913,24172
3892,310M600US31340,2022,102617,73704,28913
3893,310M600US31420,2022,91458,64099,27359
3894,310M600US31460,2022,45539,34821,10718
3895,310M600US31540,2022,303340,246596,56744
3896,310M600US31700,2022,167816,137761,30055
3897,310M600US31740,2022,51590,43672,7918
3899,310M600US31860,2022,41242,31801,9441
3900,310M600US31900,2022,50248,35183,15065
3905,310M600US32420,2022,38332,18443,19889
3906,310M600US32580,2022,270891,219395,51496
3908,310M600US32780,2022,92554,66631,25923
3909,310M600US32820,2022,518924,411990,106934
3910,310M600US32900,2022,87830,68880,18950
3912,310M600US33100,2022,2344046,1835884,508162
3913,310M600US33140,2022,43213,31865,11348
3914,310M600US33220,2022,35325,25731,9594
3915,310M600US33260,2022,71062,61926,9136
3916,310M600US33340,2022,654547,499719,154828
3917,310M600US33460,2022,1483453,1197793,285660
3919,310M600US33540,2022,53358,42678,10680
3920,310M600US33660,2022,168967,122484,46483
3921,310M600US33700,2022,177101,141950,35151
3922,310M600US33740,2022,82655,60674,21981
3923,310M600US33780,2022,62946,45010,17936
3924,310M600US33860,2022,152492,112348,40144
3926,310M600US34060,2022,57354,44736,12618
3927,310M600US34100,2022,59553,43480,16073
3930,310M600US34580,2022,50818,35548,15270
3931,310M600US34620,2022,47478,36115,11363
3932,310M600US34740,2022,67255,47837,19418
3934,310M600US34820,2022,231614,152912,78702
3935,310M600US34900,2022,51025,37997,13028
3936,310M600US34940,2022,166206,104002,62204
3937,310M600US34980,2022,831347,694094,137253
3938,310M600US35100,2022,51749,36040,15709
3940,310M600US35300,2022,345632,265184,80448
3941,310M600US35380,2022,499885,377909,121976
3943,310M600US35620,2022,7478571,5903723,1574848
3944,310M600US35660,2022,63311,45861,17450
3945,310M600US35840,2022,391897,243166,148731
3947,310M600US35980,2022,112629,84370,28259
3949,310M600US36100,2022,163513,100172,63341
3950,310M600US36140,2022,48563,34716,13847
3951,310M600US36220,2022,63738,53935,9803
3952,310M600US36260,2022,235531,199199,36332
3954,310M600US36420,2022,569766,456149,113617
3956,310M600US36500,2022,118571,89727,28844
3957,310M600US36540,2022,392615,320895,71720
3960,310M600US36740,2022,1054342,847647,206695
3961,310M600US36780,2022,72135,55154,16981
3963,310M600US36980,2022,47897,32869,15028
3964,310M600US37100,2022,278631,221598,57033
3967,310M600US37340,2022,255723,181385,74338
3968,310M600US37460,2022,79044,61739,17305
3969,310M600US37620,2022,39716,27684,12032
3970,310M600US37860,2022,207329,156557,50772
3971,310M600US37900,2022,169299,125844,43455
3972,310M600US37980,2022,2483863,1948761,535102
3973,310M600US38060,2022,1890835,1490257,400578
3974,310M600US38220,2022,30449,20428,10021
3976,310M600US38300,2022,1021314,747412,273902
3977,310M600US38340,2022,58370,41675,16695
3979,310M600US38540,2022,37564,28266,9298
3980,310M600US38660,2022,83805,43234,40571
3982,310M600US38860,2022,242440,184610,57830
3983,310M600US38900,2022,1011708,808159,203549
3984,310M600US38940,2022,201086,131061,70025
3987,310M600US39100,2022,256785,201650,55135
3988,310M600US39150,2022,110928,66308,44620
3989,310M600US39300,2022,679882,515645,164237
3990,310M600US39340,2022,208607,186659,21948
3991,310M600US39380,2022,67840,47681,20159
3992,310M600US39460,2022,90457,48924,41533
3994,310M600US39540,2022,78571,58730,19841
3995,310M600US39580,2022,559173,463488,95685
3996,310M600US39660,2022,59768,45369,14399
3997,310M600US39740,2022,162183,124544,37639
3999,310M600US39820,2022,71213,48843,22370
4000,310M600US39900,2022,200436,155889,44547
4003,310M600US40060,2022,538478,425519,112959
4006,310M600US40140,2022,1443666,1161444,282222
4007,310M600US40220,2022,133108,94665,38443
4009,310M600US40340,2022,95252,75182,20070
4010,310M600US40380,2022,456391,339984,116407
4011,310M600US40420,2022,134011,98268,35743
4012,310M600US40580,2022,58696,43337,15359
4013,310M600US40660,2022,38087,28418,9669
4016,310M600US40900,2022,884646,687158,197488
4017,310M600US40980,2022,79275,55704,23571
4018,310M600US41060,2022,78630,61416,17214
4019,310M600US41100,2022,71891,52118,19773
4020,310M600US41140,2022,47125,35363,11762
4021,310M600US41180,2022,1168546,904944,263602
4023,310M600US41420,2022,161384,121514,39870
4024,310M600US41500,2022,132411,106470,25941
4025,310M600US41540,2022,179028,124937,54091
4026,310M600US41620,2022,448172,388243,59929
4027,310M600US41660,2022,48115,37349,10766
4028,310M600US41700,2022,972848,794571,178277
4029,310M600US41740,2022,1172343,960413,211930
4032,310M600US41860,2022,1739127,1411119,328008
4033,310M600US41900,2022,47510,26687,20823
4034,310M600US41940,2022,677087,575206,101881
4035,310M600US41980,2022,833941,501022,332919
4036,310M600US42020,2022,111713,82438,29275
4037,310M600US42100,2022,96015,74879,21136
4038,310M600US42140,2022,72302,50395,21907
4039,310M600US42200,2022,150851,118712,32139
4040,310M600US42220,2022,194698,149397,45301
4041,310M600US42340,2022,163204,131163,32041
4042,310M600US42540,2022,235346,172693,62653
4044,310M600US42660,2022,1611580,1337056,274524
4045,310M600US42680,2022,72199,43510,28689
4046,310M600US42700,2022,47706,24007,23699
4050,310M600US43100,2022,50534,37967,12567
4053,310M600US43300,2022,54309,41582,12727
4055,310M600US43340,2022,157155,115911,41244
4056,310M600US43420,2022,49981,31936,18045
4057,310M600US43580,2022,58633,45657,12976
4058,310M600US43620,2022,119013,102084,16929
4061,310M600US43780,2022,127381,97015,30366
4062,310M600US43900,2022,133018,101663,31355
4063,310M600US44060,2022,240227,177307,62920
4064,310M600US44100,2022,86964,59382,27582
4065,310M600US44140,2022,277761,200364,77397
4066,310M600US44180,2022,199835,149475,50360
4067,310M600US44220,2022,56033,38387,17646
4068,310M600US44300,2022,60457,47333,13124
4070,310M600US44420,2022,50966,36930,14036
4073,310M600US44700,2022,241903,197308,44595
4074,310M600US44940,2022,53824,38932,14892
4076,310M600US45060,2022,275997,207722,68275
4078,310M600US45220,2022,156383,120518,35865
4079,310M600US45300,2022,1329075,978479,350596
4080,310M600US45460,2022,73268,52645,20623
4081,310M600US45500,2022,55624,36913,18711
4082,310M600US45540,2022,71378,25312,46066
4083,310M600US45780,2022,277534,208112,69422
4084,310M600US45820,2022,98367,71704,26663
4087,310M600US45940,2022,144989,110897,34092
4089,310M600US46060,2022,436469,315509,120960
4091,310M600US46140,2022,408399,317019,91380
4093,310M600US46220,2022,106516,79414,27102
4094,310M600US46300,2022,43679,34948,8731
4095,310M600US46340,2022,80889,62269,18620
4097,310M600US46520,2022,338438,269044,69394
4098,310M600US46540,2022,123639,87829,35810
4099,310M600US46660,2022,57838,43782,14056
4100,310M600US46700,2022,159294,122389,36905
4101,310M600US47020,2022,37469,29020,8449
4102,310M600US47220,2022,54961,42230,12731
4103,310M600US47260,2022,716273,570468,145805
4104,310M600US47300,2022,143129,117800,25329
4105,310M600US47380,2022,100777,81691,19086
4106,310M600US47460,2022,23389,16288,7101
4107,310M600US47580,2022,74524,57651,16873
4109,310M600US47900,2022,2422671,2052991,369680
4110,310M600US47940,2022,69878,52580,17298
4112,310M600US48060,2022,46815,35377,11438
4113,310M600US48140,2022,69387,50876,18511
4114,310M600US48260,2022,49583,33967,15616
4115,310M600US48300,2022,48514,36316,12198
4116,310M600US48540,2022,56516,38198,18318
4118,310M600US48620,2022,252826,199211,53615
4119,310M600US48660,2022,57968,45243,12725
4120,310M600US48700,2022,46774,34655,12119
4121,310M600US48900,2022,130017,100305,29712
4123,310M600US49020,2022,55012,43089,11923
4124,310M600US49180,2022,278269,202445,75824
4127,310M600US49340,2022,385088,301732,83356
4128,310M600US49420,2022,87616,68337,19279
4129,310M600US49500,2022,32081,18377,13704
4130,310M600US49620,2022,184019,142961,41058
4131,310M600US49660,2022,229685,160845,68840
4132,310M600US49700,2022,63162,47172,15990
4133,310M600US49740,2022,80857,56540,24317
